अकड़	اڪڙ
अकथ	اڪٿ
अकर्मक	اڪرمڪ
अकर्मी	اڪرمي
अकाल	اڪال
अकिड़्यल	اڪڙيل
अकीचार	اڪيڇار
अकीचार	اڪيچار
अकीदे	عقيدي
अकीदो	عقيدو
अकुल	عقل
अकुल	عَقُلَ
अकुलु	عقل
अकुल्मंदु	عقلمند
अकेलाई	اڪيلائي
अकेले	اڪيلي
अकेलो	اڪيلو
अकेलो	ڇڏي
अकेल्आई	اڪيلائي
अक्क्रमणु	آڪرَمَڻُ
अक्लीअ	عقليءَ
अक्लु	عقل
अक्शय्	اڪشيَ
अक्स	عڪس
अक्सर	اڪثر
अक्सीर	اڪسير
अक्सु	عڪس
अख	اک
अखर	اَکَڙ
अखर	اکر
अखरु	اکر
अखर्	اکر
अखि	اک
अखि	اَکِ
अखियुन	اکين
अखियुन	اکيُن
अखियूं	اکيون
अखुट	اکٽ
अखुट्	اکُٽ
अखंड	اکنڊ
अखंडता	اکنڊتا
अख़्तियारी	اختياري
अख़्त्यारी	اختياري
अख़्त्यारी	اَختياري
अख़्त्यारी	اَخِتياريِ
अख़्बार	اخبار
अख्युन	اکين
अख्यूं	اکيون
अगम	اگم
अगर्	اگر
अगर्च्	اگرچ
अग्यानी	اگياني
अग्यान्	اگيان
अॻकथी	اڳڪٿي
अॻते	اڳتي
अॻभरो	اڳڀرو
अॻयाड़ी	اڳياڙي
अॻयां	اَڳيان
अॻयां	اڳيان
अॻयों	آڳيون
अॻयों	اڳيون
अॻराई	اَڳرائيِ
अॻराई	چڙھائي
अॻरो	اڳرو
अॻवानी	اڳواني
अॻिएं	اَڳئين
अॻिड़ी	اڳڙي
अॻिते	اڳتي
अॻिभरो	اڳڀرو
अॻियान	اڳيان
अॻिरो	اڳرو
अॻीं	اڳين
अॻु	اڳ
अॻुवान	اڳوان
अॻुवानी	اڳواني
अॻूणा	اڳوڻا
अॻूणाई	اڳوڻائي
अॻूणो	اڳوڻو
अॻे	اَڳي
अॻे	اڳي
अघ	اگھ
अघु	اگھ
अघो	اگھو
अघोत्री	اگھوتري
अघोरी	اگھوري
अङणु	اڱڻ
अचण	اچڻ
अचणु	آچَڻُ
अचणु	اچَڻُ
अचणु	اچڻ
अचणु	اَچَڻُ
अचणु	اَچڻُ
अचण्	اچڻ
अचर्	اچر
अचल	اچل
अचल्	اچل
अची	اچي
अचूक	اچوڪ
अचेताई	اچيتائي
अचंभो	اچنڀو
अच्रज	اچرج
अच्रजु	اچرج
अछाणि	اڇاڻ
अछुतो	اڇتو
अछूत	اڇوت
अछूतो	اچوتو
अछूतो	اڇوتو
अछो	اڇو
अजब	اجب
अजब	عجب
अजबु	اجب
अजबु	عجب
अजब्	عجب
अजय	اجيَ
अजय्	اجيَ
अजसूसी	جاسوسي
अजाइब	اجائب
अजाई	اجائي
अजायो	اجايو
अज़ीज़	عزيز
अज़ीज़	عَزيز
अजीत	اجيت
अजीत्	اجيت
अजीब	اجيب
अजीब	عجيب
अजीबु	اجيب
अजीरण	اجيرڻ
अजूबो	اجوبو
अजोॻ	اجوڳ
अजोॻो	اجوڳو
अज़्ख़ुद	ازخود
अज़्ख़ुद्	ازخود
अज़्ख़ूद्	ازخود
अज्गर	اجگر
अज्गर्	اجگر
अॼु	اڄ
अॼु	اڃا
अॼुकल्ह	اڄڪله
अझलु	اجھل
अझो	آجھو
अझो	اجھو
अञा	اڃان
अञाटाईं	اڃاتائين
अञां	اڃا
अटक	اٽڪ
अटल	اٽل
अटलु	اٽل
अटल्	اٽل
अटिकल	اٽڪل
अटिकाइणु	اٽڪائڻ
अटुट	اٽٽ
अटूट	اٽوٽ
अटो	اٽو
अट्कणु	اٽڪڻ
अट्कल	اٽڪل
अट्कलबाज़ी	اٽڪلبازي
अट्कली	اَٽِڪَليِ
अट्कली	اٽڪلي
अट्कल्	اٽڪل
अट्कल्बाज़ी	اٽڪلبازي
अट्काइणु	اٽڪائڻ
अट्काउ	اٽڪاءُ
अट्पट्यो	اٽپٽيو
अठ	اَٺَ
अठोरी	اٺوري
अडम्बर	آَڊمبر
अड़ाइणु	اڙائڻ
अड़े	اڙي
अड़्चन्	اڙچن
अॾणु	اَڏَڻُ
अॾणु	اڏڻ
अॾावत	اَڏاوت
अॾावत	اڏاوت
अॾींदड़्	اڏيندڙ
अॾो	اڏو
अढ	اَڍَ
अढ	اڍ
अढंगाई	اڍنگائي
अढंगो	اڍنگو
अढ्हंगो	اڍنگو
अण	اَڻ
अण	اَڻَ
अण	اڻ
अणकप्यल	اڻڪپيل
अणखुल्यल	اڻکليل
अणगुस	اڻگھس
अणॻणित	اڻڳڻت
अणॻाणू	اڻڳاڻو
अणघड़्यल	اڻگھڙيل
अणङण्यो	اڻڳڻيو
अणचालू	اڻچالو
अणचिटाई	اڻچٽائي
अणचिटो	اڻچٽو
अणचितायो	اڻچتايو
अणछुह्यल	اڻڇهيل
अणजहिड़ो	اڻجھڙو
अणजाच्यल	اڻجاچيل
अणज़ाहिर्	اڻظاھر
अणॼाण	اڻڄاڻ
अणॼाणाई	اڻڄاڻائي
अणॼाणाईअ	اڻڄاڻائيءَ
अणॼाणे	اڻڄاڻي
अणॼाते	اڻڄاتي
अणथ्यणी	اڻٿيڻي
अणथ्यणो	اڻٿيڻو
अणपड़्हियल्	اڻپڙھيل
अणपड़्ह्यल	اڻپڙهيل
अणपरिण्यल	اڻپرڻيل
अणपुख़्तो	اڻپختو
अणपूराई	اڻپورائي
अणपूरो	اڻپورو
अणपूरो	اَڻَپوُرو
अणबणति	اڻبڻت
अणॿुधल	اڻٻڌل
अणभर्यल	اڻڀريل
अणमयो	اڻميو
अणमेल	اڻميل
अणमेल्	اڻميل
अणरिथ्यो	اڻرٿيو
अणलखा	اَڻَلَکا
अणलखो	اڻلکو
अणलभ	اڻلڀ
अणलांघो	اڻلانگھو
अणवणंदड़	اڻوڻندڙ
अणवस्यल	اڻوسيل
अणवहिंवारी	اڻوهنواري
अणवाकुफ़	اڻواقف
अणसिख्यल	اڻسکيل
अणसींगार्यल	اڻسينگاريل
अणसींगार्यलु	اڻسينگاريل
अणसुस	اڻسس
अणसोघो	اڻسوگھو
अणहिरियलु	اڻهريل
अणहूंद	اڻهوند
अणाठ	اڻاٺ
अणाठि	اڻاٺ
अणाठि	اڻاٿي
अणाठ्	اڻاٿ
अणासो	اڻاسو
अणिबणत्	اڻبڻت
अण्घड़ियो	اڻگھڙيو
अण्टर	اڻٽر
अण्पूरो	اڻپورو
अण्बणति	اڻبڻت
अण्बणत्	اڻبڻت
अण्ॿुधो	اڻٻڌو
अण्वणंदड़ु	اڻوڙندڙ
अता	عطا
अती	اتي
अती	اَتي
अत्याचार	اتياچار
अत्याचारी	اتياچاري
अत्याचारु	اتياچار
अत्याचार्	اتياچار
अत्याचार्	اَتِياچار
अत्यादार्	عَطِيادار
अथक	اٿڪ
अथाणो	اٿاڻو
अथाह	اٿاھ
अथाह	اٿاه
अदद	ادد
अदद	عدد
अददु	عدد
अदब	آدَب
अदब	ادب
अदब	اَدَب
अदब	عدب
अदबी	ادبي
अदबु	ادب
अदब्	ادب
अदा	ادا
अदाइगी	ادائگي
अदाई	ادائي
अदाकार	اداڪار
अदालत	ادالت
अदालती	عدالتي
अदालत्	عدالت
अदी	ادي
अदीब्	اديب
अदो	اَدو
अद्भुत	ادڀوت
अद्रक	ادرڪ
अद्रिशिटिता	ادرشٽتا
अद्रिश्ट	ادرشٽ
अद्वितिअ	ادوتيءَ
अध	اڌ
अधरंग	اڌرنگ
अधर्मी	اڌرمي
अधिकार	اڌڪار
अधीन	اڌين
अधीर्	اڌير
अधींता	اڌينتا
अधु	اڌ
अधूरो	اڌورو
अधूरो	اَڌوُرو
अधो	اڌو
अध्यातमक्ता	اڌياتمڪتا
अध्यातम्वादी	اڌياتموادي
अध्यात्म्वादु	اڌياتمواد
अनन्द्	آنند
अनर्थ	انرٿ
अनर्थ्	انرٿ
अनाज	اناج
अनाड़ी	اناڙي
अनाथ	اناٿ
अनाथ्	اناٿ
अनादी	انادي
अनानास	اناناس
अनार	انار
अनाव~ई	بناوتي
अनिश्चित	انشچت
अनिश्चित्	انشچت
अनु	ان
अनुपात	انپات
अनुभव	انڀو
अनुभवी	انڀو
अनुभवी	انڀوي
अनुभौ	انڀءُ
अनुमान	انمان
अनुवादक	انوادڪ
अनुवादु	انواد
अनूमान	انومان
अनूमानिक्	انومانڪ
अनूमानी	انوماني
अनूमानु	انومان
अनूमान्	انومان
अनूसार्	انوسار
अनेक	انيڪ
अनेक्	انيڪ
अनेक्ता	انيڪتا
अनोखो	انوکو
अनोखो	اَنوکو
अनंत	اننت
अनंत	اَننت
अनंत्	اننت
अनंद	آنند
अन्जामु	انجام
अन्ढारो	انڌارو
अन्दर	اندر
अन्याई	انيائي
अन्याउ	انياءُ
अपसोणी	اپسوڻي
अपहरणु	اپهرڻ
अपह्रण	اپھرڻ
अपार	اپار
अपार्दर्शक	اپاردرشڪ
अपाहिज्	اپاھج
अपंग	اپنگ
अप्छरा	اپڇرا
अप्मान	اپمان
अप्मानु	اپمان
अप्मान्	اپمان
अप्रकत्	اپرڪٽ
अप्राधी	اپراڌي
अप्राधु	اپراڌ
अप्रिय	اپريَ
अप्वाद	اپواد
अप्स्वणु	اپسوڻ
अफ़्वाह	افواه
अफ़्वाहु	افواه
अफ़्साना	افسانا
अफ़्सानो	افسانو
अफ़्सोस	افسوس
अफ़्सोसु	افسوس
अफ़्सोस्	افسوس
अबाणो	اباڻو
अबाणो	اَباڻو
अबाबील	ابابيل
अबो	ابو
अब्नासी	ابناسي
अब्रक	ابرڪ
अब्रक	ابرق
अब्रूदार्	آبروُدار
अॿोझाई	اٻوجھائي
अॿोझ्	اٻوجھ
अॿोल्	اٻول
अभाॻो	اڀاڳو
अभावु	اڀاو
अभिमानी	اڀماني
अभिमानु	اڀمان
अभेद	اڀيد
अभोॻो	اڀوڳو
अभ्मानी	اڀماني
अभ्यास	اَڀياس
अभ्यास	اَڀِياس
अभ्यास	اڀياس
अभ्यासी	اڀياسي
अभ्यास्	اڀياس
अमड़	امڙ
अमन	امن
अमर	امر
अमर्ता	امرتا
अमल	امل
अमल	عمل
अमल	عَمَلَ
अमली	عملي
अमल्दार	عملدار
अमल्दारी	عملداري
अमल्दार्	عملدار
अमानत	امانت
अमानत्	امانت
अमिट्	امٽ
अमीन	امين
अमीन	اَميِن
अमीन्	امين
अमीर	امير
अमीरी	اميري
अमीर्	امير
अमीं	امين
अमुल्ह	امله
अमुल्हु	امله
अमुल्ह्	امله
अमेरीका	اَميريڪا
अमोलक	امولڪ
अम्कान	اَمڪان
अम्ब्रत	امبرت
अम्ली	عملي
अयामी	ايامي
अयाम्कारी	ايامڪاري
अयोग्य	ايوگيَ
अयोग्यता	ايوگيتا
अरहो	ارھو
अरीज़ी	عَريضي
अर्कु	عرق
अर्ज़ी	عرضي
अर्ज़ी	عَرضيِ
अर्ज़ु	ارض
अर्ज़ु	عرض
अर्ज़्दार	عرضدار
अर्ज़्दार्	عرضدار
अर्थ्शास्त्र	ارٿشاستر
अर्थ्शास्त्री	ارٿشاستري
अर्धांग	ارڌانگ
अर्पणु	ارپڻ
अर्पियल्	ارپيل
अर्बा	عربا
अर्मान	ارمان
अर्श	عرش
अर्श्	عَرش
अर्सो	عرصو
अलई	ڪلعي
अलॻ	الڳ
अलॻ	اَلَڳ
अलॻता	الڳتا
अलाजे	الاجي
अलामत	علامت
अलील	اليل
अल्ॻाउ	الڳاءُ
अल्ॻाव	الڳاو
अल्ॻाव्	الڳاو
अल्बत	البت
अल्मारी	الماري
अल्विदा	الوداع
अल्हदो	الحدو
अवगुणु	اوگڻ
अवतार	اوتار
अवतार्	اوتار
अवर्चाई	اورچائي
अवर्जा	اورجا
अवल	اول
अवलो	اولو
अवल्	اول
अवल्यत	اوليت
अवस	اوس
अवस	اوَس
अवस्था	اوسٿا
अवाइली	اوائلي
अवाज़	آواز
अविनाशी	اوناشي
अविनाश्ता	اوناشتا
अविर्च	اوِرچ
अविवेकी	اوويڪي
अविवेकी	اوِويڪي
अविवेक्	اوويڪ
अविश्वास	اوشواس
अविश्वासी	اوشواسي
अविश्वासु	اوشواس
अवीचारी	اويچاري
अवेल	اويل
अव्चेतन	اوچيتن
अव्तार	اوتار
अव्यवस्त्हा	اويوسٿا
अव्यवस्था	اويوسٿا
अव्हां	اوهان
अव्हीं	اوهين
अशक्त	اشڪت
अशांत	اشانت
अशांती	اشانتي
अशुध	اشڌ
अशुधता	اشڌتا
अशुभ	اشڀ
अशुभ्	اَشڀ
अश्रत	عشرت
असन्गती	اسنگتي
असफल	اسڦل
असफल्ता	اسڦلتا
असभ्य	اسڀيَ
असभ्यता	اسڀيتا
असमर्थ	اسمرٿ
असमर्थी	اسمرٿي
असमर्थ्	اسمرٿ
असमाजिक	اسماجڪ
असमांता	اسمانتا
असर	اثر
असरु	اثر
असरु	اَثَرُ
असर्दार	اثردار
असहु	اسه
असहू	اسهوُ
असहू	اَسَهوُ
असह्कार	اسهڪار
असह्योग	اسهيوگ
असां	اسان
असी	اَسِي
असीम	اسيم
असीं	اسين
असुभावीक	اسڀاويڪ
असुर्	عصر
असुल	اصل
असुलियत	اصليت
असुली	اصلي
असुलु	اصل
असुल्	اصل
असुल्	دراصل
असुल्यत	اصليت
असूली	اصولي
असोच	اسوچ
असंतुलन	اَسَنتُلَن
असंतोश	اسنتوش
अस्तर्	استر
अस्मत	عصمت
अस्राइतो	اثرائتو
अस्ली	اصلي
अस्ली	اَصليِ
अस्लीपिणो	اصليپڻو
अहम	اھم
अहम	اهم
अहम्	اهم
अहम्यत	اهميت
अहिड़ी	اهڙي
अहिड़े	اهڙي
अहिड़ो	اهڙو
अहिम	اھم
अहिम्यत	اَھميت
अहिम्यत	اھميت
अहिल	اهل
अहिसान	احسان
अहिसान	اهسان
अहिसान्मंद	اهسانمند
अहिसास	حساب
अहिंज	اھنج
अहिंजो	اھنجو
अहुदो	عَهدو
अहुर	اهر
अहंकार	اھنڪار
अहंकारी	اھنڪاري
अहंजु	اهنج
अहंजो	اهنجو
अह्म्यत	اھميت
अह्वाल	احوال
अह्सान	احسان
अह्सान्मंद	احسانمند
अह्सान्मंदी	احسانمندي
अह्सास	احساس
अह्सासु	اَحساس
अंग	انگ
अंगल	انگل
अंगी	انگي
अंगु	انگ
अंगु	اَنگُ
अंगूर	انگور
अंगूर	ولي
अंगूरी	انگوري
अंगेज़	انگيز
अंगोछो	انگوڇو
अंग्रेज़ी	انگريزي
अंजाम	انجام
अंजाम्	انجام
अंजीरु	اَنجير
अंत	اَنتُ
अंत	پُڄاڻي
अंतर	انتر
अंतरिक्श	انترڪش
अंतिम्	انتم
अंतु	انت
अंत्	انت
अंदर	اندر
अंदरि	اندر
अंदर्	اندر
अंदाज़	انداز
अंदाज़ी	اندازي
अंदाज़ु	انداز
अंदाज़ो	اندازو
अंदाज़ो	اَندازو
अंदाज़्	انداز
अंदिरां	اندران
अंदिरूनी	اندروني
अंदिर्यों	اندريون
अंदेशो	انديشو
अंद्रां	اندران
अंद्रीं	اندرين
अंद्रूनि	اندروني
अंद्रूनी	اندروني
अंद्र्यों	اندريون
अंध	اَنڌُ
अंधाई	انڌائي
अंधु	انڌ
अंधेर	انڌير
अंधो	انڌو
अंबु	انب
अंबु	اَنب
अंश	انش
अंशु	انش
अंश्दानु	انشدان
आईनो	آئينو
आईंदह	آئينده
आईंदे	آئيندي
आईंदो	آئيندو
आकर्शण	آڪرشن
आकहि	آڪه
आकार	آڪار
आकार्	آڪار
आकाश	آڪاش
आकाश्वाणी	آڪاشواڻي
आकास	آڪاس
आकासी	آڪاسي
आकासु	آڪاسُ
आक्टोबर	آڪٽوبر
आक्रिती	آڪرتي
आखाड़ो	آکاڙو
आखाणी	آکاڻي
आखाणीअ	آکاڻيءَ
आख़िर	آخر
आख़िरि	آخر
आख़िर्	آخر
आख़िर्कार	آخرڪار
आखेरो	آکيرو
आख़्री	آخري
आख़्रीन	آخرين
आग	آگ
आगाही	آگاهي
आग्याकारी	آگياڪاري
आॻाटो	آڳاٽو
आघारणु	آگھارڻ
आङुड़्	آڱڙ
आङुर	آڱر
आङुरि	آڱري
आङुरु	آڱر
आङुर्	آڱر
आङूठो	آڱوٺو
आचार	آچار
आच्रणु	آچرڻ
आछ	آڇ
आछणु	آڇڻ
आछ्लाइणु	آڇلائڻ
आज़ाद	آزاد
आज़ादी	آزادي
आज़ाद्गी	آزادِگي
आजीवन	آجيون
आजीविका	آجيوڪا
आजीव्का	آجيوڪا
आजु	عاج
आजो	آجو
आजो	عاجو
आज़्माइणु	آزمائڻ
आज़्माइशी	آزمائش
आज़्माऊ	ازمائو
आज़्मायल	آزمايل
आज़्मूदो	آزمودو
आज़्मूद्गार	آزمودگار
आज़्मूद्गार्	آزمودگار
आज्यां	آجيان
आडम्बर	آڊمبر
आडम्बरी	آڊمبري
आडम्बरु	آڊمبر
आडंबर	آڊنبر
आड्~अत	آدت
आॾ	آڏ
आॾाणो	آڏاڻو
आढ	آڍ
आण	آڻ
आणण	آڻڻ
आणणु	ڻڻ
आणणु	آڻَڻُ
आणणु	آڻڻ
आणनु	آڻڻ
आणि	آڻ
आणीदड़	آڻيندڙ
आणींदड़	آڻيندڙ
आणींदड़्	آڻيندڙ
आणींदड़्	آڻيِندَڙ
आणे	آڻي
आतम	آتم
आतम	آتَم
आतशी	آتشي
आतिश्गीर्	آتشگير
आतिश्बाज़ी	آتِشبازيِ
आतुर	آتر
आतंक	آتنڪ
आतंकु	آتنڪ
आतंक्वादी	آتنڪوادي
आत्म	آتم
आत्मा	آتما
आत्मिक	آتمِڪ
आत्मिक	آتمڪ
आत्म्घाती	آتمگھاتي
आत्म्हत्या	آتمهتيا
आथतु	آٿت
आदत	آدت
आदत	عادت
आदती	عادتي
आदती	عِاَدتيِ
आदम	آدم
आदर	آدر
आदरणिय	آدَرڻِيَ
आदर्	آدر
आदर्श	آدرش
आदर्श्	آدرش
आदर्श्वाद	آدرشواد
आदर्श्वादी	آدرشوادي
आदी	عادي
आदीवासी	آديواسي
आदुर्भाउ	ادرڀاءُ
आदेश्	آديش
आधार	آڌار
आधारु	آڌار
आधी	آڌي
आधुनिक	آڌنڪ
आध्यात्मिक	آڌياتمڪ
आनाकानी	آناڪاني
आने	آني
आनंद	آنند
आनंद्	آنند
आपेशाही	آپيشاھي
आपो	آپو
आप्घात	آپگھات
आप्घाती	آپگھاتي
आप्रवासन	آپرواسن
आप्रवासी	آپرواسي
आप्रेशन	آپريشن
आप्सी	آپسي
आफ़त	آفت
आफ़ीम	آفيم
आफ़ीस	آفيس
आफ़ीसर	آفيسر
आफ़्ताबी	آفتابي
आफ़्ताबु	آفتاب
आफ़्सेट	آفسيٽ
आब	آب
आबाद	آباد
आबादी	آبادي
आबाद्	آباد
आबिद्	بد
आबी	آبي
आबु	آب
आब्कारी	آبڪاري
आब्नूस	آبنوُس
आब्पाशी	آبپاشي
आब्रू	آبرو
आब्रू	ساک
आब्रूअ	آبرو
आब्रूदार्	آبرودار
आभास	آڀاس
आभासी	آڀاسي
आम	عام
आमदनी	آمدني
आमद्	آمد
आमद्नी	آمدني
आमद्रफ़्ति	آمدرفت
आमेज़	آميز
आम्	عام
आम्दनी	آمدني
आयल	آيل
आयलु	آيل
आयोजन	آيوجن
आर	آر
आर	ار
आरक्शणु	آرڪشڻ
आरक्शित	آرڪشت
आरा	آرا
आराम	آرام
आरामी	آرامي
आरामु	آرام
आराम्	آرام
आरितुवार	آرتوار
आरी	آري
आरो	آرو
आरोपणु	آروپڻ
आरंभ	آرنڀ
आरंभु	آرنڀ
आर्ज़ी	عارضي
आर्ज़ू	آرزۇ
आर्ज़ू	آرزو
आर्डर	آرڊر
आर्थिक	آرٿڪ
आर्सी	آرسي
आर्हाई	آرھائي
आलम्	آلم
आलम्गीर	عالمگير
आलस	آلس
आलस्	آلس
आला	اعلي
आला	علي
आलाण	آلاڻ
आलाणि	آلاڻ
आलाप	آلاپ
आलिम	عالم
आलिमाणो	عالماڻو
आलीशान	آليشان
आलीशान	عاليشان
आलू	آلوُ
आलो	آلو
आलोच्ना	آلوچنا
आल्सी	آلسي
आवक	آوڪ
आवाज़	آواز
आवाज़ु	آواز
आवाज़्	آواز
आवारा	آوارا
आविश्कार	آوشڪار
आशा	آشا
आशावाद	آشاواد
आशावादी	آشاوادي
आशिक	عاشِق
आशिकु	عاشق
आश्रम	آشرم
आस	آس
आसणु	آسڻ
आसाइतो	آسائتو
आसान	آسان
आसानी	آساني
आसान्	آسان
आसामी	آسامي
आसार	آسار
आसिरो	آسرو
आसीस	آسيس
आसूदो	آسودو
आसूद्गी	آسودگي
आस्मान	آسمان
आस्मान्	آسمان
आस्रो	آسرو
आह	آه
आहट्	آهٽ
आहिन	آھن
आहिस्ते	آهستا
आहिस्ते	آهستي
आहे	آهي
आहेड़ो	آهيڙو
आह्यां	آھيان
आह्यूं	آھيون
आह्स्ते	آھستي
आह्स्ते	آهستي
आंडो	آنڊو
आंदलु	آندل
आंदोलन	آندولن
आंधी	آنڌي
इएं	۽
इएं	ائين
इएं	ايئن
इकाई	اڪائي
इकी	اڪي
इक्ख्लाकु	اخلاق
इख़ित्सार	اختصار
इख़ित्सारु	سار
इख़्तिलाफ़ी	اختلافي
इख़्लाक	اخلاڪ
इख़्लाकी	اِخِلاقيِ
इख़्लाकी	اخلاڪي
इछ	اڇا
इछा	اڇا
इज़त	عزت
इज़त	عِزَتَ
इज़ती	عزتي
इजाज़त	اجازت
इजाज़ती	اجازتي
इज़ाफ़ो	اضافو
इजार्दार	اجاردار
इज्लास	اجلاس
इज़्हार	اِزهار
इज़्हार	اظهار
इझो	اجھو
इझोई	اجھوئي
इतर	عطر
इतहासी	اِتهاسي
इतिफ़ाक	اِتِفاق
इतिरु	عطر
इतिहास	اتھاس
इते	اتي
इत्फ़ाक	اتفاق
इत्फ़ाक	اِتفاق
इत्फ़ाक	اِتِفاق
इत्फ़ाका	اتفاقا
इत्फ़ाकी	اتفاقي
इत्फ़ाकी	اِتِفاقيِ
इत्फ़ाक्	اتفاق
इत्फ़ाक्	اِتفاق
इत्लाउ	اِتلاءُ
इत्लाउ	اطلاع
इत्हाद्	اِتِحاد
इन	ان
इन	اِنَ
इनकरे	انڪري
इनहीअ	انهيءَ
इनहीअ	اِنَهيِءَ
इनहीअ	اِنَھيِءَ
इनाम	انعام
इनाम	اِنعام
इनामु	انعام
इन्कार	انڪار
इन्कार्	انڪار
इन्क्लाब	انقلاب
इन्क्लाब	ڳنقلاب
इन्क्लाबी	انقلابي
इन्चु	انچ
इन्तिज़ाम	انتظام
इन्तिज़ामी	انتظامي
इन्तिज़ाम्	انتظام
इन्त्ज़ाम	انتظام
इन्त्ज़ाम	اِنتظام
इन्त्ज़ाम्	اِنتظام
इन्त्ज़ार	انتظار
इन्सान	انسان
इन्सानु	انسان
इन्सान्यत	انسانيت
इन्साफ़	انساف
इन्साफ़	انصاف
इन्साफ़ी	انصافي
इन्साफ़ु	انصاف
इबादती	عبادتي
इमारत	عمارت
इमारती	عمارتي
इम्कान	امڪان
इम्कान	اِمڪان
इम्कानी	امڪاني
इम्कान्	امڪان
इम्तियाज़	امتياز
इम्तिहान	امتحان
इम्तिहानु	امتحان
इम्तिहानु	امتهان
इम्तिहान्	امتحان
इरादाऊं	ارادائون
इरादो	ارادو
इरादो	اِرادو
इलत	علت
इलती	علتي
इलती	علدَتيِ
इलाइको	علائقو
इलाको	علاقو
इलाको	علائقو
इलाची	الائچي
इलाज	علاج
इलाज	عِلاج
इलाजु	علاج
इलाज्	علاج
इलाही	الاهي
इलाही	الاھي
इलिम	علم
इल्ज़ाम	الزام
इल्ज़ाम	الظام
इल्ज़ाम्	الزام
इल्म	علم
इल्म	عِلِمُ
इल्मी	علمي
इल्मु	علم
इल्विजान्	وِجان
इल्हामी	الهامي
इशारा	اِشارا
इशारो	اشارو
इशारो	اِشارو
इश्क	عشق
इश्क्बाज़ी	عشق
इश्त्हार	اشتهار
इसिमु	اسم
इस्कूल्	اسڪول
इस्टाक	اسٽاڪ
इस्टिकरु	اسٽڪر
इस्टूडिओ	اسٽوڊئو
इस्टेशन	اسٽيشن
इस्तलाहु	اصطلاح
इस्तवा	اِستوا
इस्तीफ़ा	استعفا
इस्तीफ़ा	استيفا
इस्तेमाल	استعيمال
इस्तेमाल	استيعمال
इस्तेमालु	استعيمال
इस्त्री	استري
इस्त्लाह	استلاه
इस्त्लाहत	اصطلاحت
इस्थाई	اسٿائي
इस्थान	اسٿان
इस्थानिक्	اسٿانڪ
इस्थापित	اسٿاپت
इस्थापिन	اسٿاپن
इस्थाप्ना	اِسٿاپنا
इस्थिर	اسٿر
इस्थिर्ता	اسٿرتا
इस्पताल्	اسپتال
इस्मु	اسم
इस्रार	اسرار
इस्रारी	اسراري
इस्लाह	اصلاح
इहा	اها
इहे	اهي
इहो	اهو
इहो	اھو
इंघाइणु	انگھائڻ
इंजिणि	انجڻ
इंज्नेरु	اِنجنير
इंत्ज़ाम	انتظام
इंत्ज़ार	اِنتظار
इंशा	انشا
इंसान	انسان
ई	ئي
ईज़ाअ	ايزاءَ
ईज़ाइणु	ايذائڻ
ईज़ाउ	ايذاءُ
ईजाद	ايجاد
ईजाद्	ايجاد
ईमन्दारी	ايمانداري
ईमान	ايمان
ईमानी	ايماني
ईमान्	ايمان
ईमान्दाई	ايمانداري
ईमान्दार	ايماندار
ईमान्दारी	ايمانداري
ईमान्दारीअ	ايمانداريءَ
ईमान्दार्	ايماندار
ईमांदार	ايماندار
ईर्खा	ايرکا
ईर्खालू	ايرکالو
ईश्वर	ايشور
ईश्वरी	ايشوري
ईश्वर्	ايشور
ईश्वर्ता	ايشورتا
ईंघ	اينگھ
ईंघाइणु	اينگھائڻ
ईंघंदड़्	اينگھندڙ
ईंदड़	ايندڙ
ईंदड़ु	ايندڙ
ईंदड़्	ايندڙ
ईंदो	ايندو
उकीर	اڪير
उक्रणु	اُڪرَڻُ
उक्रणु	اڪرڻ
उखारणु	اکارڻ
उखिलणु	اکلڻ
उखेड़णु	اکيڙڻ
उखेलणु	اکيلڻ
उख्ड़णु	اُکڙَڻُ
उख्री	اکري
उग़ड़णु	اگھاڙڻ
उॻाड़णु	اڳاڙڻ
उघणु	اگھڻ
उघाड़णु	اگھاڙڻ
उघाड़प	اگھاڙپ
उघाड़ो	اگھاڙو
उचारण	اچارڻ
उचारणु	اچارڻ
उचारु	اچار
उचित	اچت
उछातिरो	اڇاترو
उछात्रो	اڇاترو
उछारो	اڇارو
उछालणु	اڇالڻ
उछांग्	اڇانگ
उछिलणु	اڇلڻ
उछिलाइणु	اڇلائڻ
उछ्लणु	اڇلڻ
उछ्लाइणु	اُڇلائڻ
उछ्लाइणु	اڇلائڻ
उजूरो	اجورو
उज़्वन	عضون
उज़्वो	عضوو
उझाम	اُجھام
उझामण	اجھامڻ
उञ	اڃ
उञायलु	اڃايل
उठु	اٺ
उडाई	اڊائي
उडेरणु	اڊرڻ
उॾही	اڏهي
उॾाइणु	اُڏائڻ
उॾाइणु	اڏائڻ
उॾाई	اڏائي
उॾाऊ	اڏائو
उॾाए	اُڌائي
उॾाम	اڏام
उॾामणु	اڏامڻ
उॾामी	اڏامي
उॾामंदड़्	اڏامندڙ
उॾी	اُڏي
उॾोही	اڏوهي
उॾंदड़	وانگر
उणणु	اُڻڻ
उणणु	اڻڻ
उणति	اڻت
उणियलु	اڻيل
उण्यल	اُڻيل
उण्यलु	اڻيل
उण्वीह	اڻويه
उतपती	اتپتي
उतम	اتم
उतम	اُتم
उतमु	اتم
उतम्	اتم
उतम्	اُتم
उतारू	اتارو
उतावलो	اُتاولو
उताहूं	اتاهون
उतां	اتان
उतिरणु	اترڻ
उते	اتي
उते	اُتي
उतेजना	اُتيجنا
उतेज्ना	اتيجنا
उत्कंठा	اتڪنٺا
उत्सवु	اتسو
उत्साह	اتساه
उत्साह	اُتساه
उत्साह	اُتساهَ
उत्साही	اتساهي
उत्साही	اُتِساهيِ
उत्साही	اتساھي
उत्साहु	اتساه
उत्साहु	اُتساه
उत्साह्	اتساھ
उत्साह्	اتساه
उत्सुक्ता	اتسڪتا
उथणु	اٿڻ
उथल	اٿل
उथारणु	اٿارڻ
उथिलाइणु	اٿلائڻ
उथ्लणु	اٿلڻ
उथ्लाइणु	اٿلائڻ
उथ्ली	اٿلي
उथ्लंदड़	اٿلندڙ
उथ्ल्यल	اُٿِيَل
उदम	ادم
उदम	اُدم
उदम	اُدَم
उदम	اُدَمُ
उदम्	اڏام
उदार	ادار
उदार	اُدار
उदार्चित्	ادارچت
उदार्ता	ادارتا
उदास	اداس
उदास	اُداس
उदासाई	اداسي
उदासी	ادآسي
उदासी	اداسي
उदासी	اُداسيِ
उदासीअ	اداسيءَ
उदासीन्	اداسين
उदास्	اداس
उदास्	اُداسمنحوس
उदेश	اديش
उद्घाटन	ادگھاٽن
उद्योग्	اُديوگ
उधार	اڌار
उधारु	اڌار
उधारो	اڌارو
उन	ان
उनजे	انجي
उन्हारो	انهارو
उन्हीअ	انهيءَ
उप	اپ
उपज	اپج
उपत	اپت
उपत	ڱپت
उपति	اپت
उपदेशकु	اپديشڪ
उपनगर	اپنگر
उपनदी	اپندي
उपयोगु	اپيوگ
उपाइणु	اپائڻ
उपाईंदड़	اپائيندڙ
उपाईंदड़्	اپائيندڙ
उपाउ	اپاءُ
उपासकु	اپاسڪ
उपासना	اپاسنا
उप्करणु	اپڪرڻ
उप्कारी	اپڪاري
उप्टार्	اپٽار
उप्देश	اپديش
उप्देशक	اپديشڪ
उप्नाम	اپنام
उफ़क	افق
उफ़्फ़	اف
उबतड़	ابتڙ
उबतड़ि	ابتڙ
उबतड़्	اُبتڙ
उबतरी	ابتري
उबतर्	ابتر
उबतो	ابتو
उबतो	اُبتو
उबतो	اُبَتو
उबत्री	ابتري
उॿ	اٻ
उॿथो	اٻٿو
उॿहिराई	اٻهرائي
उॿहिरो	اٻهرو
उॿासी	اٻاسي
उॿासी	اُٻايِ
उभक्प्रो	اڀڪپرو
उभामणु	اُڀامَڻُ
उभारु	اڀار
उभिड़ियलु	اڀڙيل
उभु	اڀ
उभो	اڀو
उभ्रणु	اڀرڻ
उभ्रंदड़	اڀرندڙ
उभ्रंदाई	اڀرندائي
उभ्रंदे	اُڀرَندي
उभ्र्यल	اُڀِرِيَل
उमर	عمر
उमालक	امالڪ
उमिरि	عمر
उमिर्	عمر
उमिर्दराज़ी	عمردرازي
उमीद	اميد
उमीदी	اميدي
उमीद्	اميد
उमेद	اميد
उमेद	اُميد
उमेद	اُميدَ
उमेद्वार	اميدوار
उमेद्वार	عميدوار
उमेद्वार्	اميدوار
उमंग	امنگ
उमंग	اُمنگ
उमंग्	اُمَنگ
उम्दो	امدو
उम्दो	عمدو
उलट	الٽ
उलहंदे	الهندي
उलास्	الاس
उलू	الو
उलेख	اليک
उलंघन	اُلنگھن
उलंघनु	النگھن
उलंघन्	اُلنگھن
उल्का	الڪا
उल्झन	الجھڻ
उल्झन	الجھن
उल्झन्	الجھن
उल्झाइणु	الجھائڻ
उल्टाइणु	الٽائڻ
उल्टी	الٽي
उल्टी	اُلٽي
उल्टो	الٽو
उल्टो	اُلٽو
उल्थो	الٽو
उस	اس
उस	اُس
उसवारो	اسوارو
उसाट	اساٽ
उसाटियलु	اساٽيل
उसिरणु	اسرڻ
उसूल	اصول
उसूल	اُصوُلَ
उसूलु	اصول
उस्ताद	استاد
उस्तादी	استادي
उस्तादु	استاد
उस्ताद्	استاد
उस्त्रो	استرو
उस्रणु	اسرڻ
उस्रंदड़	اسرندڙ
उहिदो	عُھِدو
उहिदो	عهدو
उहे	اهي
उहो	اهو
उहो	اُھو
उह्देदार	عهديدار
उह्देदार्	عھديدار
उह्देदार्	عُهِديدار
उह्दो	عهدو
ऊच	اوچ
ऊचाई	اوچائي
ऊचाए	اوچائي
ऊचो	اوچو
ऊजल	اوجل
ऊणाई	اوڻائي
ऊणाओ	اوُڻائو
ऊणो	اوڻو
ऊनी	اوني
ऊन्हाई	اونچائي
ऊन्हो	اونھو
ऊॿड़	اوٻڙ
ऊंचाई	اوُنچائي
ऊंचाई	اوُنچائيِ
ऊंचो	اوُنچو
ऊंधह	اونڌَهِ
ऊंधो	اونڌو
ऊंहो	اونهو
एकागर	ايڪاگر
एकांत	ايڪانت
एके	ايڪي
एको	ايڪو
एक्ता	ايڪتا
एक्स्क्रे	ايڪِسِڪِري
एॾो	ايڏو
एतिरे	ايتري
एतिरो	ايترو
एत्रे	ايتري
एत्रो	ايترو
एराज़ी	ايراضي
एराज़ी	عيراضي
एल्ची	ايلچي
एल्ची	اِيلچي
एल्चीअ	ايلچيء
एल्चीअ	ايلچيِءَ
एवज़	عيوض
एवज़ो	عيوِضو
एवज़्	عيوض
एविज़ो	عيوزو
एव्ज़ी	عيوضي
एव्ज़ो	عيوضو
एश्याई	ايشيائي
एह्मकु	اھمق
ऐत्बार	اعتبار
ऐत्बार	ايتبار
ऐत्बारी	اعتباري
ऐत्बारी	اعيتباري
ऐत्बारी	ايتباري
ऐत्बारु	اعيتبار
ऐत्बार्	اعتبار
ऐत्राज़	اعتراض
ऐत्राज़	عيتراز
ऐत्राज़ु	اعيتراز
ऐब	غيب
ऐबु	عيب
ऐब्	عيب
ऐब्जू	عَيبَجو
ऐलान	اعلان
ऐलान्	اعلان
ऐलान्	اعيلان
ऐश	عيش
ऐश	عيشَ
ऐश्	عيش
ऐं	۽
ऐं	ائين
ओ	او
ओक्ड़ू	اوڪڙو
ओॻराई	اوڳرائي
ओघड़	اوگھڙ
ओचिती	اوچتو
ओचितो	اوچتو
ओचितो	اوچِتو
ओच्ती	اوچتي
ओच्तो	اوچتو
ओजाॻो	اوجاڳو
ओज़ारु	اوزار
ओज़ारु	اوزارُ
ओज़ार्	اوزار
ओजु	اوج
ओॼ	اوڄ
ओझो	اوجھو
ओट	اوٽ
ओड़ो	اوڙو
ओढ्णी	اوڍني
ओणो	اوڻو
ओतणु	اوٽڻ
ओतणु	اوتڻ
ओथारो	اوٿارو
ओधर्	اوڌر
ओन	اونَ
ओनी	اوني
ओॿारणु	اوٻارڻ
ओभर	اوڀر
ओभरु	اوڀر
ओरांघणु	اورانگھڻ
ओलह	اوله
ओलहु	اوله
ओलाद	اولاد
ओलाद्	اولاد
ओसीड़ो	اوسيڙو
ओसो	اوسو
ओस्ताईं	اوستائين
ओस्राणि	اسراڻي
ओह	او
औखो	اوکو
औज	اوجَ
औज	ائوجَ
औज़ार्	اَوزار
औजु	اَوج
औरत	عورت
औरतूं	عورتون
औलाद	اولاد
औलाद	اَولاد
औलादु	اولاد
औलादु	عولاد
औलाद्	اولاد
कईं	ڪئين
कक	ڪڪ
ककर	ڪڪر
ककरन	ڪڪرن
ककि	ڪَڪِ
ककि	ڪڪ
कक्री	ڪڪري
कक्रो	ڪَڪرو
कख	ڪک
कचहिरी	ڪچهري
कचालू	ڪَچالو
कची	ڪچي
कचो	ڪچو
कच्रो	ڪچرو
कछ	ڪَڇَ
कछऊं	ڪَڇَئوُن
कछुओ	ڪڇئو
कजलु	ڪجل
कज़ा	قضا
कञिरी	ڪڃري
कञ्री	ڪڃري
कट	ڪٽ
कटणु	ڪٽڻ
कटणु	ڪاٽَڻُ
कटणु	ڪتڻ
कटर	ڪٽر
कटर्	ڪَٽَر
कटर्	ڪٽر
कटर्पणो	ڪٽرپڻو
कटिजणु	ڪٽجڻ
कटियलु	ڪٽيل
कटु	ڪٽ
कटे	ڪٽي
कटो	ڪٽو
कट्यलु	ڪَٽيَلُ
कठो	ڪٺو
कठोर	ڪٺور
कठोर्	ڪٺور
कठोर्ता	ڪٺورتا
कठ्पुत्ली	ڪٺپتلي
कड़क	ڪڙڪ
कडणु	ڪڍڻ
कड़नि	ڪڙن
कड़ाई	ڪَڙائيِ
कड़ी	ڪڙي
कड़ी	ڪڙيِ
कड़्काटु	ڪڙڪاٽ
कड़्के	ڪڙڪي
कड़्को	ڪڙڪو
कड़्कंदड़	ڪڙڪندڙ
कड़्छी	ڪڙڇي
कॾहिन	ڪڏهن
कॾहिं	ڪڏھن
कॾहिं	ڪڏهن
कढ	ڪَڍَ
कढणु	ڪَڍَڻُ
कढणु	ڪڍَڻُ
कढणु	ڪڍڻ
कढी	ڪَڍي
कढी	ڪڍي
कढी	ڪڍيِ
कढंदड़	ڪڍندڙ
कढंदड़ु	ڪڍندڙ
कढ्यलु	ڪڍيل
कढ्हणु	ڪڍڻ
कणु	ڪڻ
कण्क	ڪڻڪ
कतई	ڪتائي
कतणु	ڪتڻ
कतब	ڪَتَب
कतर	ڪتر
कतल	قتل
कतलु	قتل
कतल्	قتل
कतार	قطار
कतिरणु	ڪترڻ
कतिरो	قطرو
कत्रणु	ڪترڻ
कत्लाम	قتلام
कथ	ڪَٿَ
कथ	ڪٿ
कथणु	ڪَٿَڻُ
कथन	ڪٿن
कथा	ڪٿا
कथाऊं	ڪٿائون
कदम	قدم
कदमु	قدم
कदर	قدر
कदावर	قداور
कदिरी	ڪدري
कदीम	قديم
कदु	قد
कदुर	قدر
कदुरु	قدر
कदुरु	قَدرُ
कदुर्	قدُرُ
कदू	ڪدوُ
कदूकश	ڪدوڪش
कद्री	قدري
कन	ڪن
कनु	ڪَنُ
कनूनी	قانوُنيِ
कन्गाल	ڪنگال
कन्जूस	ڪنجوس
कन्दड़ु	ڪندڙ
कन्या	ڪنيا
कप	ڪپ
कपटु	ڪپٽ
कपणु	ڪپڻ
कपाटु	ڪپاٽ
कपिड़ो	ڪپڙو
कपु	ڪپ
कप्चो	ڪپچو
कप्टी	ڪپٽي
कप्ड़ा	ڪپڙا
कप्ड़े	ڪپڙي
कप्ड़ो	ڪپڙو
कप्ड़ो	لِباسُ
कप्ड़ो	ڪڀڙو
कप्तान्	ڪپتان
कप्प	ڪپ
कफ़नु	ڪفن
कफ़ु	ڪف
कबर	قبر
कबरिस्तान्	قبرستان
कबीलाई	قبيلائي
कबूतरु	ڪبوتر
कबूतर्	ڪبوتر
कबूल	قبول
कबूलण	قبولڻ
कबूलियत्	قَبوُلِيَتَ
कबूल्यत	قبوليت
कबूल्यत्	قبوليت
कब्ज़ि	ڪبض
कब्ज़ी	قبضي
कब्ज़े	قبضي
कब्ज़ेदार	قبضيدار
कब्ज़ेदारी	قبظيداري
कब्ज़ो	قبضو
कब्ज़ो	قبظو
कब्र	قبر
कब्रिस्तान	قبرستان
कॿट्	ڪٻٽ
कम	ڪم
कम	ڪَمَ
कमचलाऊ	ڪامچلائو
कमरि	ڪمر
कमल्	ڪمل
कमाइणु	ڪَمائِڻُ
कमाइणु	ڪمائيندڙ
कमाइतो	ڪمائتو
कमाई	ڪمائي
कमान	ڪَمان
कमान्	ڪمان
कमाल	ڪمال
कमालियत्	ڪماليت
कमि	ڪم
कमी	ڪمي
कमीणाई	ڪميڻائي
कमीणो	ڪمينو
कमीणो	ڪميڻو
कमु	ڪم
कमु	ڪَم
कम्	ڪم
कम्ज़ोर	ڪمزور
कम्ज़ोरी	ڪمزوري
कम्ज़ोरु	ڪمزور
कम्ज़ोर्	ڪمزور
कम्तर	ڪمتر
कम्बख़्ती	ڪمبختي
कम्बल	ڪمبل
कम्रो	ڪمرو
कयल	ڪيل
कयल	ڪَيَل
कयलु	ڪيل
कयल्	ڪيل
कयामत	قيامت
कयो	ڪيو
कर	ڪر
करण	ڪرڻ
करणु	ڌار
करणु	ڪارڻ
करणु	پورَڻُ
करणु	ڪرڻ
करणु	ڪرڻُ
करणु	ڪَرَڻُ
करणु	ڪَرڻ
करणु	ڪَرڻُ
करणु	ڪري
करणु	کرڻ
करणु	ليلائِڻُ
करणु	موهِت
करणु	وِجھَڻُ
करणु	ڏيڻُ
करणुबेकार	ڪرڻبيڪار
करण्	ڪرڻ
करनु	ڪَرَڻُ
करम्	ڪرم
करम्चारी	ڪرمچاري
करर्णु	ڪرڻُ
कराइणु	ڪرائڻ
कराई	ڪرائي
कराईंडड़	ڪرائيندڙ
कराईंदड़्	ڪرائيِندَئڙ
कराणु	ڪرڻ
करामत	ڪرامت
करामती	ڪرامتي
करायल्	ڪرايل
कराहत	ڪراھت
करीब	ڪريب
करे	ڪري
करे	ڪَري
कर्ज़ु	فرض
कर्ज़ु	قرض
कर्ज़्	قرض
कर्ज़्दार	قرضدار
कर्ज़्दार्	قرضدار
कर्टाइणु	ڪرٽائڻ
कर्ड़ो	ڪرڙو
कर्णी	ڪرڻي
कर्णु	ڪرڻ
कर्तब	ڪرتب
कर्ता	ڪرتا
कर्तूत	ڪرتوت
कर्योस	ڪريوس
कल	ڪل
कलई	قلئي
कलफ़ु	قلف
कलम	قلم
कलम	قَلَم
कलमी	قلمي
कलम्	قلم
कलराठी	ڪلراٺي
कलशु	ڪلش
कलसु	ڪلس
कला	ڪَلا
कलाकार	ڪلاڪار
कलाक्	ڪلاڪ
कलाबाज़ी	ڪلابازي
कली	ڪلي
कलेजो	ڪليجو
कलंक	ڪلنڪ
कलंकु	ڪلنڪ
कलंगी	ڪلنگي
कल्प	ڪلپ
कल्पना	ڪلپنا
कल्प्ना	ڪلپنا
कल्याणु	ڪلياڻ
कल्यूं	ڪليون
कल्ह	ڪله
कवाइदु	قواعد
कविता	ڪوتا
कवी	ڪوي
कवीता	ڪويتا
कश	ڪش
कशणु	ڪشڻ
कशश	ڪشش
कशालो	ڪشالو
कशिश	ڪشش
कशिश	ڪوشش
कशिश्	ڪشش
कशु	ڪش
कश्टु	ڪشٽ
कश्ती	ڪشتي
कश्यल	ڪشيل
कश्यलु	ڪشيل
कसदु	ڪسد
कसम	قسم
कसमु	قسم
कसारो	ڪسارو
कसी	ڪسي
कसु	ڪس
कसूर	قصور
कसोटी	ڪسوٽي
कस्तूरी	ڪستوري
कस्बो	قسبو
कस्यल	ڪسيل
कस्रत	ڪسرت
कहाणी	ڪھاڻي
कहिड़े	ڪهڙي
कहिड़ो	ڪهڙو
कहिर	ڪهر
कहिं	ڪنھن
कहिंखे	ڪهنکي
कही	ڪهي
कही	ڪھي
कहुरो	ڪهرو
काइदगी	قائدگي
काइदे	قاعدي
काइदे	قائدي
काइदो	قاعدو
काइदो	قاعِدو
काइदो	قائدو
काइम	قائم
काइमु	قائم
काइम्	قائم
काई	ڪائي
काकिड़ो	ڪاڪڙو
काकूसु	ڪاڪوس
काको	ڪاڪو
काग़ज़	ڪاغز
काग़ज़्	ڪاغَذ
काॻर	ڪاڳَر
काछो	ڪاڇو
काट	ڪاٽ
काटणु	ڪاٽَڻُ
काटणु	ڪاٽڻ
काटि	ڪاٽ
काटिकू	ڪاٽڪو
काट्कू	ڪاٽڪو
काठ	ڪاٺ
काठियूं	ڪاٺيون
काठी	ڪاٺي
काठु	ڪاٺ
काठेरु	ڪاٺير
काठोड़ो	ڪاٺوڙو
कातिल	قاتل
कातिल्	قاتل
काथी	ڪآٿيِ
काना	ڪانا
कानियारो	ڪانيارو
कानून	قانون
कानूनन	قانونن
कानूनी	قانوني
कानून्	قانون
कानून्यत	قانونيت
कानो	ڪانو
काफ़िर्	ڪافر
काफ़िलो	قافلو
काफ़ी	ڪافي
काफ़ी	قافيِ
काफ़ूर	اڏندڙ
काफ़्यो	قافيو
काबिल	قابل
काबिलियत	قابليت
काबिलु	قابل
काबिल्	قابل
काबिल्यत	قابليت
काबुल	قابل
काबुली	قابلي
काबू	ڪابو
काबू	قابو
काब्लियत	قابليت
काब्लियत्	قابليت
काम	ڪام
कामी	ڪامي
कामु	ڪام
कामुक	ڪامڪ
कामुक्	ڪامڪ
कामुक्ता	ڪامڪتا
काम्चोर्	ڪامچور
काम्भाव्ना	ڪامڀاونا
काम्याबी	ڪاميابي
काम्याबु	ڪامياب
कायर्ता	ڪايرتا
काया	ڪايا
कायापलट	ڪاياپلٽ
कार	ڪار
कारणु	ڪارڻ
कारसिरो	ڪارسرو
कारा	ڪارا
काराइतो	ڪارائتو
कारीगर	ڪاريگر
कारीगरी	ڪاريگري
कारीगर्	ڪاريگر
कारे	ڪاري
कारो	ڪارو
कारोबार	ڪاروبار
कारोबार्	ڪاروبار
कारंहिं	ڪاراهن
कारंहिं	ڪارنھن
कार्	ڪار
कार्ख़ानो	ڪارخانو
कार्गर	ڪارگر
कार्गार	ڪارگار
कार्गुज़ारी	ڪارگزاري
कार्य	ڪاريـ
कार्यक्रम्	ڪاريَڪرم
कार्वाई	ڪارروائي
कार्वाई	ڪاروائي
काल	ڪال
कालु	ڪال
काल्ह	ڪاله
कावड़	ڪاوڙ
कावड़्	ڪاوڙ
काविड़ाइणु	ڪاوڙائڻ
काविड़्यल	ڪاوڙيل
काविड़्यलु	ڪاوڙيل
काव्ड़ाइणु	ڪاوڙائڻ
काव्ड़्यल्	ڪاوڙيل
कासाई	ڪاسائي
कासिद	قاسد
कासिद	قاصِد
काह	ڪاه
काहिणु	ڪاھڻ
काहिणु	ڪاهڻ
काहिल	ڪاهل
काहे	ڪاهي
कां	ڪان
कांइरु	ڪانئر
कांग	ڪانگ
कांच	ڪانچ
कांचु	ڪانچ
कांजी	ڪانجي
कांटो	ڪانٽو
कांवु	ڪانو
कि	ڪ
किचिरो	ڪچرو
किच्	ڪِچ
किच्रे	ڪچري
किच्रो	ڪچرو
किट्ली	ڪٽلي
किताब	ڪتاب
किताबु	ڪتاب
किताब्	ڪتاب
किताब्ची	ڪتابچي
किताब्ड़ी	ڪتابڙي
कित्किताई	ڪتڪتائي
किथां	ڪٿان
किथे	ڪٿي
किनारी	ڪناري
किनारे	ڪناري
किनारो	ڪنارو
किनिखे	ڪنکي
किनु	ڪن
किनो	ڪنو
किफ़ाइती	ڪفائتي
किफ़ायट	ڪفايت
किफ़ायत	ڪفايت
किफ़ायत	ڪفايتَ
किफ़ायत	ڪَفايَتَ
किफ़ायत	قفايت
किफ़ायती	ڪِفايَتيِ
कियास्	قياس
किरण	ڪرڻ
किरणु	ڪرڻ
किरणो	ڪرڻو
किराएदार	ڪرائيدار
किराएदारी	ڪرائيداري
किरायो	ڪِرايو
किराहत	ڪراھت
किराहत	ڪراهت
किराहित	ڪراهت
किराह्त	ڪراھت
किरिणो	ڪرڻو
किरी	ڪري
किरीअ	ڪريء
किरोध	ڪروڌِ
किरोधी	ڪروڌي
किरंदड़ु	ڪرندڙ
किर्च	ڪرچ
किर्ड़ी	ڪرڙي
किर्यलु	ڪريل
किली	ڪلي
किले	قلعي
किलेबंदी	قلعيبندي
किलो	قلعو
किलो	قلو
किल्क	ڪلڪ
किशोर	ڪشور
किशोरु	ڪشور
किशोर्	ڪشور
किसा	قصا
किसिमु	قسم
किसो	قسو
किसो	قصو
किस्त	قسط
किस्मत	قسمت
किस्मत्	قسمت
किस्मन	قسمن
किस्मु	قسم
किस्में	قسمين
किंझणु	ڪنجھڻ
की	ڪي
कीअं	ڪيئن
कीक	ڪيڪ
कीकूं	ڪيڪون
कीचड़	ڪيچڙ
कीड़ो	ڪيڙو
कीतो	ڪيتو
कीमट	قيمت
कीमत	قيمت
कीमती	قيمتي
कीमत्	قيمت
कीमो	ڪيمو
कीम्ती	قيمتي
कीर्तन	ڪيرتن
कीर्तन्	ڪيرتن
कींअन	ڪيِنئَن
कींअरो	ڪينئرو
कींओं	ڪينئون
कुकिड़ि	ڪڪڙ
कुकुड़ु	ڪُڪُڙُ
कुकुड़ु	ڪڪڙ
कुखि	ڪکي
कुछ	ڪڇ
कुछणु	ڪڇڻ
कुछु	ڪڇ
कुझ	ڪجھ
कुझु	ڪجھ
कुझु	ڪجه
कुट	ڪٽ
कुटणु	ڪٽڻ
कुटुम्ब्	ڪٽنب
कुटंब	ڪٽنب
कुट्या	ڪٽيا
कुड़िम्पिणो	ڪُڙِمپِڻو
कुड़्मी	ڪڙمي
कुॾणु	ڪڏڻ
कुढंगाई	ڪڍنگائي
कुतिरि	ڪتر
कुते	ڪتي
कुतो	ڪتو
कुत्रणु	ڪترڻ
कुत्रींदड़	ڪتريندڙ
कुदर्ती	قدرتي
कुदिर्ती	قدرتي
कुद्रत	قدرت
कुद्रती	قدرتي
कुधो	ڪڌو
कुनी	ڪني
कुनु	ڪن
कुनो	ڪنو
कुन्याउ	ڪنياءُ
कुपटी	ڪپٽي
कुपटी	ڪُپَٽيِ
कुपत्यो	ڪپٽيو
कुॿु	ڪٻ
कुमहिलो	ڪمهلو
कुमारी	ڪماري
कुमी	ڪمي
कुरणु	ڪرڻ
कुर्कण	ڪرڪڻ
कुर्कणु	ڪرڪڻ
कुर्कणु	ڪُرِڪَڻُ
कुर्कुणो	ڪرڪڻو
कुर्ब	قرب
कुर्बाइतो	قربائتو
कुर्बानी	قرباني
कुर्बु	قرب
कुर्सी	ڪرسي
कुर्सी	ڪُرسي
कुल	ڪل
कुलछ्णो	ڪلڇڻو
कुलाइतो	ڪلائتو
कुलीन	ڪلين
कुलु	ڪل
कुल्फ़ु	ڪلف
कुल्हेगस	ڪلھيگس
कुल्हो	ڪلهو
कुल्हो	ڪُلهو
कुशल	ڪشل
कुशल्ता	ڪشلتا
कुशा	ڪشا
कुशादो	ڪشادو
कुशादो	ڪُشادو
कुशाद्गी	ڪشادگي
कुशासन	ڪشاسن
कुश्ती	ڪشتي
कुश्ती	ڪُشتيِ
कुश्तीबाज़ु	ڪشتيباز
कुहणु	ڪهڻ
कुहाड़ी	ڪھاڙي
कुहाड़ी	ڪهاڙي
कुहिणो	ڪهڻو
कुंआरिपो	ڪُنئارپو
कुंआरी	ڪنئاري
कुंजी	ڪنجي
कुंड	ڪنڊ
कुंडु	ڪنڊُ
कुंडो	ڪنڊو
कुंड्ली	ڪنڊلي
कुंभार	ڪنڀار
कुंभारु	ڪنڀار
कुंवारो	ڪنوارو
कुंवार्	ڪنوار
कूओ	ڪوئو
कूक	ڪوڪ
कूच	ڪوچ
कूट	ڪوٽ
कूड़	ڪوڙ
कूड़णु	ڪوڙڻ
कूड़ी	ڪوڙي
कूड़ु	ٺاه
कूड़ु	ڪوُڙ
कूड़ु	ڪوڙ
कूड़ो	ڪوُڙو
कूड़ो	ڪوڙو
कूत	قوت
कूमाइजणु	ڪومائجڻ
कूमाइणु	ڪومائڻ
कूमाइन्जणु	ڪوُمائِجَڻُ
कूली	ڪولي
कूंअरो	ڪونئرو
कूंडी	ڪونڊي
कूंडो	ڪونڊو
केॾाहुं	ڪيڏاهن
केॾांहुं	ڪيڏانهن
केत्रा	ڪيترا
केत्राई	ڪيترائي
केत्रो	ڪيترو
केन्द्र	ڪيندر
केराइणु	ڪيرائڻ
केरायल	ڪيرايل
केरु	ڪير
केलो	ڪيلو
केवी	ڪيوي
केसर	ڪيسر
केंद्रु	ڪيندر
कै	ڪَئِ
कैद	قيد
कैदी	قيدي
कैद्	قيد
कैद्ख़ानो	قيدخانو
को	ڪو
कोइलो	ڪوئلو
कोई	ڪوئي
कोको	ڪوڪو
कोचु	ڪوچ
कोझाई	ڪوجھائي
कोटु	ڪوٽ
कोठ	ڪوٺ
कोठणु	ڪوٺَڻُ
कोठणु	ڪوٺڻ
कोठाइणु	ڪوٺائڻ
कोठी	ڪوٺي
कोठ्यो	ڪوٺيو
कोड़्को	ڪوڙڪو
कोड़्हु	ڪوڙه
कोॾयो	ڪوڏيو
कोॾरि	ڪوڏري
कोॾर्	ڪوڏر
कोॾाइणु	ڪوڏائڻ
कोॾी	ڪوڏي
कोताह	قوتاه
कोताह	ڪوتاهي
कोताही	ڪوتاهي
कोताही	ڪوتاھي
कोप	ڪوپ
कोम	قوم
कोम	قومَ
कोमल	ڪومل
कोमल्ता	ڪوملتا
कोमी	قومي
कोम्यत	قوميت
कोयल्	ڪويل
कोरट	ڪورٽ
कोरी	ڪوري
कोरीअड़ो	ڪوريئڙو
कोर्टि	ڪورٽ
कोशश	ِڪوشَش
कोशश्	ڪوشش
कोशिश	ڪوشش
कोशिश्	ڪوشش
कोसु	ڪوس
कोसो	ڪوسو
कोहीड़ो	ڪوھيڙو
कौड़ो	ڪوڙو
कौम	قوم
कौम	قَوم
कौमी	قومي
कौलु	قول
कंगणु	ڪنگڻ
कंगाल	ڪنگال
कंगाल	ڪَنگال
कंगाली	ڪنگالي
कंगाल्पणो	ڪنگالپڻ
कंजूस	ڪنجوس
कंजूस्	ڪنجوس
कंझणु	ڪنجھڻ
कंठी	ڪنٺي
कंठु	ڪنٺ
कंडड़	ڪندڙ
कंडे	ڪنڊي
कंडो	ڪندو
कंडो	ڪنڊو
कंड्यारो	ڪنڊيارو
कंदड़	ڪرائيندڙ
कंद~ड़	ڪندڙ
कंदड़	ڪندڙ
कंदड़ु	ڪندڙ
कंदड़्	ڪندڙ
कंदड़्	ڪَندَڙ
कंदड़्	ڪَندَڙُ
कंदड़्	ڪَندڙ
कंधीअ	ڪنڌيءَ
कंधु	ڪنڌ
कंधो	ڪنڌو
कंबणु	ڪنبڻ
कंबणु	ڪَنبَڻُ
कंवल्	ڪنول
कंवाठी	ڪنواٺي
कंहिं	ڪنھن
कंहिं	ڪنهن
क्यास	قياس
क्यासु	قياس
क्राहित	ڪراهت
क्रांती	ڪرانتي
क्रांतीकारी	ڪرانتيڪاري
क्रिड़ी	ڪِرِڙيِ
क्रिपा	ڪرپا
क्रिया	ڪريا
क्रियाकरम	ڪرياڪرم
क्रियाशील्	ڪرياشيل
क्रोध	ڪروڌ
क्रोधी	ڪروڌي
क्रोधु	ڪروڌ
खखरु	ککر
खख्ड़ी	ککڙي
खॻयून	کڳيون
ख़चर	خچر
ख़चर्	خَچَڙُ
ख़ज़ानो	خزانو
ख़ज़ांची	خزانچي
खजूर	کجور
ख़जूर	کجور
खट	کَٽِ
खट	کٽ
खटणु	کٽڻ
खटी	کَٽيِ
खटी	کٽي
खटो	کَٽو
खटो	کٽو
खटोलो	کٽولو
खटंदड़	کٽندڙ
खट्याणी	کٽياڻي
खट्यो	کٽيو
खड़क	کَڙَڪِ
खड़ाई	کڙائي
खड़ो	کڙو
खड़ोतड़ो	کڙوتڙو
खड़्काइणु	کڙڪائڻ
खड़्खॿड़	کڙکٻڙ
खड़्ॻ	کڙڳ
खॾ	کڏ
खॾो	کڏو
खणण	کڻڻ
खणणु	ڪرڻ
खणणु	کَڻَڻُ
खणणु	کڻڻ
खणणु	کڻڻُ
खणाणी	کڻاڻي
खणी	کَڻيِ
खणी	کڻي
खणंदड़	کڻندڙ
खणंदड़ु	کڻندڙ
खणंदड़्	کڻندڙ
खण्णु	کڻڻ
ख़त	خت
ख़तम	ختم
ख़तम	خَتَم
ख़तम	خطم
ख़तम्	ختم
ख़तर्नाक	خترناڪ
ख़तर्नाक	خطرناڪ
ख़तर्नाकु	خطرناڪ
ख़तर्नाक्	خطرناڪ
ख़ता	خطا
ख़तु	خط
ख़तू	خاتو
ख़त्रे	خطري
ख़त्रो	خطرو
खद्ड़ो	کدڙو
खन्हणु	کنهڻ
खपाइणु	کپائِڻُ
खपाइणु	کپائڻ
खपाए	کپائي
खपे	کپي
ख़फ़ा	خفا
ख़फ़े	خفي
ख़फ़्ती	خفتي
ख़फ़्तु	خفت
खबर	خبر
ख़बर	خبر
ख़बर्चार	خبرچار
ख़बर्दार	خبردار
ख़बर्दारी	خبرداري
ख़बर्दार्	خبردار
ख़ब्री	خبريِ
ख़मीरु	خمير
ख़मीस	خميس
खयलु	کَيَلُ
ख़यामत	خيامَت
ख़याली	خيالي
ख़राब	خراب
ख़राबी	خرابي
ख़राब्	خراب
ख़रीद	خريد
ख़रीदण	خريدڻ
ख़रीदार	خريدار
ख़रीदारी	خريداري
ख़रीदार्	خريدار
ख़र्गोश	خرگوش
ख़र्गोश्	خرگوش
ख़र्च	خرچ
ख़र्चणु	خرچَڻُ
ख़र्चणु	خرچڻ
ख़र्चाऊ	خرچائو
ख़र्चालू	خرچالو
ख़र्ची	خرچي
ख़र्चींदड़्	خرچيندڙُ
खर्चु	خَرچُ
ख़र्चु	خرچ
ख़र्चु	خرچُ
ख़र्ज	خارج
खल	کل
ख़लक	خلڪ
ख़लक	خلق
ख़लास	خلاص
ख़लास	خَلاص
ख़लासी	خلاسي
ख़लासी	خلاصي
ख़ल्क	خلڪ
ख़ल्कत्	خلقت
ख़वाब	خواب
खसणु	کسڻ
ख़सी	خصي
ख़सीस	خسيس
ख़सीस	خصيص
ख़सीस्	خسيس
ख़सूसा	خصوصا
खसे	کسي
ख़स्यत	خاصيت
खहुराईअ	کهرائيءَ
खहुरो	کھرو
खहुरो	کهرو
खह्यो	کهيو
खा	کان
खाइण	کائڻ
खाइणु	کائِڻُ
खाइणु	کائڻ
खाइणु	کائڻُ
खाई	کائي
खाईंदड़्	کائيندڙ
खाऊ	کائو
ख़ाक	خاڪ
ख़ाको	خاڪو
खाॼणु	کاڄڻ
खाॼा	کاڄا
खाॼु	کاڄ
खाड़ी	کاڙي
खाॾी	کاڏي
खाण	کاڻ
खाणि	کاڻ
ख़ातिमो	خاتمو
ख़ातिर	خاطر
ख़ातिरी	خاتري
ख़ातिरीअ	خاتريءَ
ख़ातिर्ख़्वाह	خاترخواه
ख़ातो	خاتو
खातो	کاتو
ख़ात्मो	خاتمو
ख़ात्री	خاتري
ख़ात्र्दारी	خاطرداري
खादो	کادو
खाधल	کاڌل
खाधि	کاڌ
खाधे	کاڌي
खाधो	کاڌو
ख़ानाबदोश	خانابدوش
ख़ानो	خانو
खानो	کانو
ख़ान्गी	خانگي
ख़ान्दानी	خانداني
ख़ान्दान्	خاندان
खापो	کاپو
ख़ाबिरू	خابرو
खाॿड़	کاٻڙ
खाॿो	کاٻو
खाम	کام
ख़ामी	خامي
ख़ामोश	خاموش
ख़ामोशी	خاموشي
खारणु	کارڻ
खाराइणु	کارائڻ
खाराईंदड़्	کارائيندڙ
ख़ारिज	خارج
खारिज	کارج
ख़ारु	خار
खारो	کارو
ख़ार्बाज़	خارباز
ख़ार्स्	خارس
ख़ालिक्	خالق
खालिस	خالص
खाली	خاليِ
ख़ाली	خالي
ख़ालु	خال
ख़ालु	خالُ
ख़ास	خاص
ख़ास	خزص
ख़ासियत	خاصيت
ख़ासो	خاصو
ख़ास्	خاص
ख़ास्यत	خاصيت
खाही	کاهي
खाही	کاھي
खां	کان
ख़ां	کان
खांगारो	کانگهارو
ख़ांगी	خانگي
खांचो	کانچو
खांभाणी	کانڀاڻي
खिच	کِچ
खिचावु	کچاو
खिजाइणु	کجائڻ
ख़िज़्मत	خذمت
खिट्पिटि	کٽپٽ
खिट्राॻ	کِٽِراڳ
खिट्राॻी	کٽراڳي
खिड़्ॿिड़	کڙٻڙ
खिड़्ॿिड़्यो	کڙٻڙيو
खिण	کڻ
ख़िताबु	ختاب
ख़िद्मत्गार	خدمتگار
खिनु	کن
खिम्या	کميا
खिम्यावान	کمياوان
ख़ियाल	خيال
खिरो	کڙو
खिल	کل
खिल	کِل
खिलण	کلڻ
खिलणु	کلڻ
खिलाइणु	کلائڻ
खिलाईंदड़	کلائيندڙ
खिलाईंदड़्	کلائيندڙ
ख़िलाफ़	خلاف
खिली	کلي
खिलंदे	کلندي
खिल्णो	کلڻو
खिवणि	کوڻ
खिविणि	کوڻ
खिसक्णु	کسڪڻ
खिस्कणु	کسڪڻ
खिस्काइणु	کسڪائڻ
खिस्की	کسڪي
खीकार	کيڪار
खीकारणु	کيڪارڻ
खीर	کير
खीरु	کير
खीरूं	کيروُن
खीसे	کيسي
खीसो	کيسو
खुज्ली	کجلي
खुटल	کُٽَلُ
खुटल	کٽل
खुटलु	کٽل
खुटाइणु	کٽائڻ
खुटु	کُٽُ
खुट्को	کٽڪو
ख़ुडाई	خدائي
खुड़ी	کڙي
खुॾु	کڏ
खुतल	کتل
ख़ुद	خود
ख़ुदा	خدا
ख़ुदा	خُدا
ख़ुदाई	خدائي
ख़ुदाई	خودائي
ख़ुदी	خودي
ख़ुद्कुशी	خودڪشي
ख़ुद्ग़र्ज़	خودغرض
ख़ुद्ग़र्ज़ी	خودغرضي
खुद्दारी	خودداري
ख़ुद्मुख़्त्यारी	خودمختياري
ख़ुद्याव्री	خدياوري
खुपाइणु	کپائڻ
ख़ुमारु	خومار
खुरिणण	کرڻڻ
खुरु	کر
खुर्ड़णु	کرڙڻ
खुर्ड़े	کرڙي
खुलणु	کلڻ
खुलम्खुलो	کلمکلو
खुलायो	کلايو
ख़ुलासाई	خلاصائي
ख़ुलासी	خلاصي
ख़ुलासो	خلاسو
ख़ुलासो	خلاصو
खुलियो	کليو
खुल्यल	کليل
खुल्यल्	کليل
खुल्यो	کليو
खुल्यो	کُلِيو
ख़ुवाइश्मंद्	خوائشمند
ख़ुवाब	خواب
ख़ुवारी	خواري
ख़ुवार्	خوار
खुश	خوش
ख़ुश	خوش
ख़ुश	خوُش
ख़ुशामदी	خوشامدي
ख़ुशामद्	خوُشامد
ख़ुशामद्ड़ियो	خوشامدڙيو
ख़ुशामद्ड़्यो	خوشامدڙيو
ख़ुशामंद	خشامندي
ख़ुशामंद	خوشامند
ख़ुशि	خوشي
ख़ुशी	خوشي
खुशीअ	خوشيء
खुशीअ	خوشيءَ
खुशीअ	خوشيِءَ
ख़ुशीअ	خوشيء
ख़ुशीअ	خوشيءَ
ख़ुश्	خوش
ख़ुश्क	خشڪ
ख़ुश्की	خشڪي
खुश्की	کشڪي
ख़ुश्कीअ	خشڪيءَ
ख़ुश्कु	خشڪ
ख़ुश्बू	خوشبو
ख़ुश्बू	خوُشبوءَ
ख़ुश्बूदार	خوشبودار
ख़ुश्बूदार्	خوشبودار
खुंद	کند
खुंभी	کنڀي
ख़ून	خون
ख़ूनिणि	خونڻ
ख़ूनी	خوني
ख़ूनु	خون
ख़ून्	خون
ख़ूब	خوب
ख़ूबी	خوبي
ख़ूबी	خوُبي
ख़ूबी	خوُبيِ
खूॿो	کوُٻو
खूरो	کورو
खूरो	کوُرو
खूशी	خوشي
ख़ूशी	خوشي
ख़ूश्	خوش
खूहु	کوه
ख़ूंख़ार	خونخوار
ख़ूंख़ार्	خوُنخار
खे	کي
खेख्ड़ो	کيکڙو
खेचल	کيچل
खेच्लो	کيچلو
ख़ेज़	خيز
खेड़णु	کيڙڻ
खेॾणु	کيڏڻ
खेतर	کيتر
खेती	کيتي
खेती	کيتيِ
खेतीअ	کيتيءَ
खेप्	کيپ
ख़ेमो	خيمو
खेल	کيل
खेलु	کيل
ख़ैर	خير
खैराती	خيراتيِ
ख़ैरात्	خيرات
ख़ैरु	خير
ख़ैर्यत	خيريت
खोखो	کوکو
खोख्लो	کوکلو
खोज	کوج
खोज्न	کوجنا
खोज्ना	کوجنا
खोट	کوٽ
खोटणु	کوٽَڻُ
खोटणु	کوٽڻ
खोटाई	کوٽائِي
खोटि	کوٽ
खोटि	کوٽي
खोटींदड़	کوٽيندڙ
खोटींदड़ु	کوٽيندڙ
खोटींदड़्	کوٽيندڙُ
खोटे	کوٽي
खोटो	کوٽو
खोड़णु	کوڙڻ
खोड़ा	کوڙا
खोपो	کوپو
खोप्ड़ी	کوپڙي
ख़ोम्चो	خومچو
ख़ोर	خور
ख़ोराक	خوراڪ
ख़ोरी	خوري
ख़ोरु	خور
खोर्	خور
ख़ोर्	خور
खोलणु	کولَڻ
खोलणु	کولڻ
खोलिणी	کولڻيِ
खोलीं~अड़	کوليندڙ
खोले	کولي
खोहिणु	کوھڻ
खोंघ्रा	کونگھرا
खौड़ो	کَوِرو
ख़ौफ़	خوف
ख़ौफ़ाइतो	خوفائتو
ख़ौफ़्	خوف
ख़ौफ़्नाक्	خوفناڪ
खंउणु	کَنئُڻُ
खंघणु	کنگھڻ
खंघ्	کنگھ
ख़ंजरु	خنجر
ख़ंजर्	خنجر
खंडन	کنڊن
खंडहर	کنڊهر
खंडु	کنڊ
ख़ंदक	خندڪ
ख़ंदक	خندق
खंभु	کنڀ
खंभु	کَنڀُ
खंयल्	کنيل
ख़्याल	خيال
ख़्याली	خيالي
ख़्यालु	خيال
ख़्यालो	خيالو
ख़्याल्	خيال
ख़्वाब्	خواب
ख़्वार्	خوار
ख़्वाह	خواه
ख़्वाहान	خواهان
ख़्वाहिश	خواھش
ख़्वाही	خواهي
ख़्वाह्शी	خُواهِشيِ
गजणु	گجڻ
गजर	گجر
गज़र्गाहु	گزرگاه
गजी	گجي
गजीअ	گجيءَ
गज़ु	گز
गज्गोड़	گجگوڙ
गड़	گڙ
गड	گد
गड़्गड़ाहट	گھڙگھڙاهٽ
गड़्ॿड़	گڙٻڙ
गड़्ॿड़ि	گڙءڙ
गड़्ॿड़्	گڙٻڙ
गॾ	گڏ
गॾजण	گڏجڻ
गॾजणु	گڏجڻ
गॾजाणी	گَڏِجاڻيِ
गॾजी	گڏجي
गॾणु	گَڏَڻُ
गॾणु	گڏڻ
गॾयल	گڏيل
गॾयल	گَڏِيَل
गॾयल्	گڏيل
गॾयल्	گَڏِيَلَ
गॾहि	گڏه
गॾहु	گڏھ
गॾह्	گَڏَه
गॾिजण	گڏجڻ
गॾिजणु	گڏجڻ
गॾियलु	گڏيل
गॾु	گَڌُ
गॾु	گڏ
गॾे	گڏي
गणित	گڻت
गतिज्	گتج
गतीशील्ता	گتيشيلتا
गद	گڏ
गद	گد
गदा	گدا
गदी	گدي
गदेलो	گاديلو
गद्	گڏ
गद्	گد
गद्गद्	گدگد
गद्लो	گدلو
गप	گپ
गपाइणु	گپائڻ
गपागीह	گپاگيه
गपोड़ा	گپوڙا
गपोड़ी	گپوڙي
गपोड़ो	گپوڙو
ग़फ़िलत	غفلت
ग़फ़्लत	غفلت
ग़मु	غم
ग़मु	غَمُ
ग़म्गीन	عَمگيِن
ग़म्गीन	غمگين
ग़म्गीनी	غمگيني
गम्भीर	گنڀير
गरम	گرم
गरम्	گرم
ग़रिक	غَرڪ
ग़रीब	غريب
ग़रीबाणो	غريباڻو
ग़रीबी	غريبي
ग़रीब्	غريب
ग़र्क	غرق
गर्जना	گرجنا
ग़र्ज़ाऊ	غرضائوُ
गर्ज़्	غرض
गर्दशी	گردشي
गर्दाबु	گرداب
गर्दिश	گردش
गर्द्बाद	گردباد
गर्भ	گرڀ
गर्भवती	گرڀوتي
गर्भु	گرڀ
गर्भ्वती	گرڀوتي
गर्माइश	گرمائش
गर्माश	گرماش
गर्मी	گرمي
गर्मीअ	گرميءَ
ग़लत	غلط
गलाबंद	گلابند
गली	گلي
ग़लीज़	غليظ
गले	گلي
गलो	گلو
गलो	گَلو
ग़ल्तान	غلطان
ग़ल्तानी	غلتاني
ग़ल्तान्	غَلطان
ग़ल्ती	غلطي
ग़ल्ती	غلطيم
ग़ल्तीअ	غلطيءَ
ग़ल्त्यूं	غلطيون
गवाह	گواه
गवाही	گواهي
गवैयो	گوئيو
गवैयो	گَوَئيو
गशा	گشا
ग़शु	غش
गश्तु	گشت
गसणु	گسڻ
गसु	گس
गसु	گسُ
गस्यल्	گسيل
गहणु	گهڻ
गहिपी	گهپي
गहिरो	گھرو
गह्पीअ	گهپيءَ
गह्री	گهري
गह्रो	گھرو
गाइकी	گائڪي
ग़ाइब	غائب
गाॾड़	گاڏڙ
गाॾयुन	گاڏين
गाॾी	گاڏي
गाॾीअ	گاڏيءَ
गादेलो	گاديلو
गानो	گانو
ग़ाफ़िल	غافل
ग़ाफ़िल्	غافل
गाबिरू	گابرو
गाबो	گابو
गाब्रो	گابرو
गामु	گام
गायक	گايڪ
गायका	گايڪا
ग़ार	غار
गारियुन	گارين
गारियुन	گاريون
गारियुन्ख़ोर	گاريُنخور
ग़ालिब	غالب
ग़ालीचो	غاليچو
गास्लेट्	گاسليٽ
गाह	گاھ
गाह	گاه
गाहु	گاه
गांइ	گان
गांइ	گانءِ
गांगटु	کانکٽ
गांगटु	گانگٽ
गांजो	گانجو
गिग	گگ
गिगूं	گگون
ग़िज़ा	غذا
गिदड़ु	گدڙ
गिदामिड़ी	گدامڙي
गिद्रो	گدرو
गिप्जणु	گپجڻ
गियानी	گياني
गिरफ़्तार	گرفتار
गिरफ़्तारी	گرفتاري
गिरह	گره
गिरहु	گره
गिरावट	گراوٽ
गिराहकु	گراهڪ
गिरिफ़्तार	گِرَفِتار
गिरिफ़्तारी	گرفتاري
गिर्जाघर	گرجاگھر
गिर्वी	گروي
गिर्वीदार	گرويدار
गिला	گلا
गिलाख़ोर	گلاخور
गिल्टी	گلٽي
गिहिलणु	گھلڻ
गिहिलणु	گهلڻ
गिहीअणु	گھيئڻ
गिह्लणु	گهلڻ
गीतु	گيت
गीदीपिणो	گيديپڻو
गीसाइणु	گيسائڻ
गुज़रु	گذر
गुज़ारण	گذارڻ
गुज़ारणु	گذارڻ
गुज़ारणु	گزارڻ
गुज़िरान	گذران
गुज़िरानु	گذران
गुज़िर्यल	گذريل
गुजी	گجي
गुज़्रणु	گذرڻ
गुज़्रान	گذران
गुज़्रान्	گذران
गुज़्रियल	گذريل
गुज़्री	گُذري
गुड़	گڙ
गुॾी	گڏي
गुण	گڻ
गुणी	گڻي
गुणु	گڻ
गुणो	گڻو
गुणोतर	گڻوتر
गुण्वानु	گڻوان
गुतो	گتو
गुदाम	گدام
गुदामु	گدام
गुदाम्	گدام
गुनहगार	گنهگار
गुनह्गार	گنهگار
गुनाह	گناه
गुनाहु	گناه
गुनाह्	گناھ
ग़ुनो	غنو
गुन्गुनाइणु	گنگنائڻ
गुप्त	گپٽ
गुप्त	گپت
गुप्त्	گپت
ग़ुफ़ा	غُفا
गुफ़्तगू	گفتگو
गुफ़्तगू	گفتگوُ
ग़ुबारु	غبار
गुम	گم
गुमान	گمان
गुमानु	گمان
गुमान्	گمان
गुम्	گم
गुम्नाम	گمنام
गुम्नामी	گمنامي
गुम्नाम्	گُمنام
गुम्राह	گمراھ
गुम्राह	گمراه
गुम्राह	گھمراه
गुम्राह	گُمِراه
गुम्राह्	گمراہ
गुरिड़ी	گرڙي
गुरू	گروُ
गुर्दो	گردو
गुल	گل
गुलन	گلن
गुलनि	گلن
गुलाब	گلاب
गुलाबी	گلابي
ग़ुलाम	غلام
ग़ुलाम	غُلام
ग़ुलामी	عُلاميِ
ग़ुलामी	غلامي
गुलिरु	گلر
गुलु	گل
गुलेल	گليل
गुल्दस्तो	گلدستو
गुसाइणु	گسائڻ
ग़ुसे	غصي
ग़ुसो	غصو
गुसो	گُسو
गुस्ताख़	گستاخ
गुस्ताख़ी	گستاخي
गुस्ताख़ीअ	گستاخي
गुस्ताख़्	گستاخ
गुंजाइश	گنجائش
गुंडो	گنڊو
गूंगो	گونگو
गूंजणु	گونجڻ
गूंजंदड़	گونجندڙ
गेह्राण्	گيھراڻ
गेह्रो	گيھرو
गेंडी	گينڊي
गेंदे	گيندي
ग़ैड़	غير
ग़ैबत	غيبت
ग़ैब्	غائب
ग़ैर	غير
गैस	گَيس
गोइ	گوءِ
गोड़	گوڙ
गोड़ीलो	گوڙيلو
गोड़ु	گوڙ
गोड़ु	گوڙُ
गोड़्	گوڙ
गोड़्हा	گوڙها
गोॾन	گوڏن
गोॾो	گوڏو
ग़ोता	غوتا
ग़ोतो	گھوتو
गोथ्नाथी	گوٿَناٿيِ
गोद	گود
गोदि	گود
गोधी	گوڌي
गोबर्	گوبر
गोबी	گوبي
गोबो	گوبو
गोया	گويا
गोरी	گوري
गोरी	گوريِ
गोरो	گورو
गोल	گول
गोलाई	گولائي
गोलाओं	گولائون
गोलाकार	گولاڪار
गोलाटी	گولاٽي
गोली	گولي
गोलु	گول
गोलो	گولو
गोल्मटोल	گولمٽول
गोल्माल्	گولمال
गोशाइतो	گوشائتو
गोशे	گوشي
गोश्त	گوشت
गोहीर्	گوھير
ग़ौर	غور
ग़ौरु	غور
ग़ौर्	غور
गंगा	گَنگا
गंजी	گنجي
गंजु	گنج
गंजो	گنجو
गंद	گند
गंदगी	گندگي
गंदी	گندي
गंदु	گند
गंदु	گَندُ
गंदो	گندو
गंभीर	گنڀير
गंभीर्ता	گنڀيرتا
ग्यान	گيان
ग्यानी	گياني
ग्यानु	گيان
ग्यान्	گيان
ग्यान्	گِيان
ग्रम्	گرامر
ग्रह	گره
ग्रहण	گرھڻ
ग्रहण	گرهڻ
ग्रहणु	گِرِهَڻُ
ग्रहनि	گرهن
ग्रहिस्त	گِرَهِسِت
ग्रहु	گره
ग्रहु	گرَهُ
ग्रामर	گرامر
ग्राहक	گراهڪ
ग्राहकु	گراهڪ
ग्राहिकी	گراھڪي
ग्राहिक्	گراھڪ
ग्राह्कु	گراھڪ
ग्रिफ़्तारी	گِرِفِتاريِ
ग्रेडु	گريڊ
ॻऊं	ڳئَوُن
ॻझॻोह	ڳجھڳوه
ॻठो	ڳٺو
ॻठ्ड़ी	ڳٺڙي
ॻठ्ड़ो	ڳٺرو
ॻड़्ह्यल	ڳڙهيل
ॻणण	ڳڻڻ
ॻणणु	ڳڻڻ
ॻणत	ڳڻت
ॻणत्	ڳَڻَتِ
ॻणप	ڳَڻَپَ
ॻणप	ڳڻپ
ॻण्ती	ڳڻتي
ॻण्प	ڳڻپ
ॻनी	ڳني
ॻनु	ڳن
ॻन्	ڳن
ॻन्ढणु	ڳَنڍَڻُ
ॻभु	ڳڀ
ॻभ्रू	ڳبرو
ॻभ्रू	ڳڀرو
ॻरण	ڳرڻ
ॻरणु	ڳرڻ
ॻरन	ڳَڙَن
ॻरी	ڳري
ॻरु	ڳر
ॻरो	ڳرو
ॻरो	ڳَرو
ॻरंदड़	ڳرندڙ
ॻर्यल	ڳريل
ॻहणु	ڳهڻ
ॻहु	ھه
ॻाइणु	ڳائڻ
ॻाईंदड़	ڳائيندڙ
ॻाछा	ڳاڇا
ॻाछा	ڳَاڇا
ॻाटे	ڳاٽي
ॻाड़णु	ڳاڙڻ
ॻाड़्हाणि	ڳاڙھاڻ
ॻाड़्हो	ڳاڙهو
ॻाड़्हो	ڳاڙھو
ॻाड़्ह्यूं	ڳاڙھيون
ॻारणु	ڳارڻ
ॻारींदड़	ڳاريندڙ
ॻारु	ڳار
ॻारो	ڳارو
ॻालाहिण	ڳالهائڻ
ॻालाहींदड़ु	ڳالهائيندڙ
ॻालाहू	ڳالهائو
ॻालिह	ڳالھ
ॻालिह	ڳاله
ॻाल्ह	ڳالھ
ॻाल्ह	ڳاله
ॻाल्हाइण	ڳالھائڻ
ॻाल्हाइण	ڳالهائڻ
ॻाल्हाइणु	ڳالھائڻ
ॻाल्हाइणु	ڳاِلھائِڻُ
ॻाल्हाइणु	ڳالهائِڻُ
ॻाल्हाइणु	ڳالهائڻ
ॻाल्हाईंदड़	ڳالِهائينِدَڙ
ॻाल्हाईंदड़्	ڳالهائيندڙ
ॻाल्हाऊ	ڳالهائو
ॻाल्हि	ڳاھ
ॻाल्हि	ڳالھ
ॻाल्हि	ڳاله
ॻाल्ह्	ڳالھ
ॻाल्ह्	ڳاله
ॻाल्ह्यूं	ڳالهيون
ॻिची	ڳچي
ॻिझ	ڳج
ॻिटी	ڳٽي
ॻिन्हणु	ڳنهڻ
ॻिर्काइणु	ڳرڪائڻ
ॻीत	ڳيِتَ
ॻीही	ڳيهي
ॻुझारत	ڳجھارت
ॻुझी	ڳجھي
ॻुझु	ڳجھ
ॻुझो	ڳجھو
ॻुझो	غجھو
ॻुझ्ड़ो	ڳجھڙو
ॻुड़ु	ڳڙ
ॻुतियलु	ڳتيل
ॻुत्यल्	ڳتيل
ॻूड़्हो	ڳوڙهو
ॻूड़्हो	ڳوُڙھو
ॻूण	ڳوُڻ
ॻूणि	ڳوڻ
ॻोठ	ڳوٺ
ॻोठाणो	ڳوٺاڻو
ॻोठु	ڳوٺ
ॻोड़्हा	ڳوڙها
ॻोड़्हो	ڳوڙهو
ॻोड़्हो	ڳوڙھو
ॻोथ्री	ڳوٿري
ॻोला	ڳولا
ॻोल्हणु	ڳولھڻ
ॻोल्हणु	ڳولهڻ
ॻोल्हा	ڳولها
ॻोल्हाऊ	ڳولهائو
ॻोल्हींदड़्	ڳولھيندڙ
ॻोल्हे	ڳولهي
ॻोल्हे	ڳولھي
ॻोहिणु	ڳوھڻ
ॻोहियलु	ڳوھيل
ॻौरो	ڳورو
ॻंडी	ڳنڍي
ॻंढ	ڳنڊ
ॻंढणु	ڳنڊڻ
ॻंढि	ڳنڍ
ॻंढिरु	ڳنڊر
ॻंढ्यलु	ڳنڍيل
ॻंवार	ڳنوار
ॻंवार	ڳَنوار
ॻंवारु	ڳنوار
घघो	گھگھو
घट	گھٽ
घटणु	گھٽڻ
घटा	گهٽا
घटाइणु	گھٽائڻ
घटाई	گھٽائي
घटाउ	گھٽاءُ
घटि	گھَٽ
घटि	گھَٽِ
घटि	گھٽ
घटि	گهٽ
घटिजणु	گھٽجڻ
घटिताई	گھٽتائي
घटिताईन्	گھٽتائين
घटियल	گھٽيل
घट्	گھٽ
घट्जणु	گھٽجڻ
घट्ताई	گھٽتائي
घट्ना	گھٽنا
घट्यलु	گھٽيل
घड़णु	گھڙڻ
घड़प	گڙپ
घड़ियाल्	گھڙيال
घड़ियो	گھڙيو
घड़ी	گھڙي
घड़ीअ	گھڙيءَ
घड़ो	گھڙو
घड़्णी	گهڙڻي
घड़्यल	منگھڙيل
घण	گھڻ
घणरूप	گھڻروپ
घणा	گھڻا
घणाई	گھڻائي
घणि	گھڻ
घणी	گھڻي
घणीए	گھڻيئي
घणे	گھڻي
घणो	گَھڻو
घणो	گھَڻو
घणो	گھڻو
घतणु	گھتڻ
घताई	گھٽائي
घॿराइणु	گھبرائڻ
घॿराइणु	گھٻرائڻ
घॿरायल	گھٻرايل
घॿरायलु	گھٻرايل
घॿराहट	گھٻراهٽ
घॿराहट्	گھٻراھٽ
घॿराहत	گھٻراهٽ
घॿरो	گھٻرو
घॿिराइणु	گھبرائڻ
घॿिराइणु	گھٻرائڻ
घमंडी	گھمنڊي
घमंडु	گھمنڊ
घर	گھر
घर	گھَرَ
घरवारी	گھرواري
घराणो	گھراڻو
घरु	گھر
घरु	گھَرُ
घरू	گھرو
घर्घर	گھرگھر
घर्घराईंदड़	گھرگھرائيندڙ
घर्घ्राहट	گھرگھراهٽ
घसीटणु	گھسيٽڻ
घाइणु	گھائڻ
घाइल	گھائل
घाइलु	گهائل
घाउ	گھاءُ
घाघ्रो	گھاگھرو
घाटा	گھاٽا
घाटि	گھاٽِ
घाटी	گھاٽي
घाटु	گھاٽ
घाटेरो	گھاٽيرو
घाटो	گھاٽو
घातक	گھاتڪ
घातक्	گھاتڪ
घातु	گھات
घायल्	گھايل
घिटी	گھٽي
घिड़ण	گھڙڻ
घिड़णु	گھڙڻ
घिण्कणु	گھڻڪڻ
घिण्कार	گھڻڪار
घिम	گھم
घिमियल्	گھميل
घिम्यल	گھميل
घिम्यलु	گھميل
घिरण	گھرڻ
घिरणु	گِھرَڻُ
घिरणु	گهرڻ
घिरंडड़ु	گهرندڙ
घिरंदी	گھرندي
घिलणु	گھلڻ
घिंड	گھنڊ
घिंडिड़ीअ	گھنڊڙيءَ
घिंडु	گھنڊ
घुघी	گھگھي
घुघू	گھگھو
घुटणु	گھٽڻ
घुटन	گھٽن
घुटो	گھٽو
घुट्यल	گھٽيل
घुन्जणु	گھنجڻ
घुन्जाइणु	گھنجائڻ
घुपाइणु	گھپائڻ
घुॿु	گھٻ
घुमणु	گھمڻ
घुमाइणु	گھمائڻ
घुम्तारी	گھمتاري
घुम्रो	گھمرو
घुर	گھر
घुरणु	گھرڻ
घुराइणु	گھرائڻ
घुरंदड़	گھرندڙ
घुर्ज	گھرج
घुर्जाऊ	گھرجائو
घुर्जूं	گھُرجوُن
घुर्जे	گھرجي
घुर्बल्	گھُربَل
घुर्यो	گھريو
घुसणु	گھسڻ
घुसी	گھسيِ
घुस्पेठ्	گھسپيٺ
घुंजु	گھج
घुंडी	گھنڊي
घुंडीदार्	گھنڊيدار
घुंडु	گھنڊ
घूमाट	گھوماٽ
घूरणु	گهورڻ
घूंघटु	گھونگھٽ
घेटो	گھيٽو
घेड़णु	گھيڙڻ
घेर	گھير
घेरणु	گھيرَڻُ
घेरा	گھيرا
घेरि	گھير
घेरो	گھيرو
घोघो	گھوگھو
घोटणु	گھوٽڻ
घोटालो	گھوٽالو
घोटु	گھوٽ
घोटु	گھوٽُ
घोड़ी	گھوڙي
घोड़े	گھوڙي
घोड़ो	گھوڙو
घोमू	گھومو
घोमू	گھوموُ
घोर	گھور
घोशे	گھوشي
घोश्णा	گھوشڻا
घोश्ना	گھوشنا
चएवान	چئيوان
चकर	چَڪَر
चकर	چڪر
चकरु	چڪر
चकर्दार	چڪردار
चकास	چڪاس
चकासणु	چڪاسڻ
चकी	چڪي
चकु	چڪ
चक्नाचूर	چڪناچور
चक्मक	چقمق
चक्राऊं	چڪرائون
चक्रो	چڪرو
चक्रो	ڇڪرو
चॻर	چڳر
चघु	چگھ
चङमुड़्सी	چڱمڙسي
चङाई	چَڱائي
चङी	چڱي
चङीअ	چَڱيءَ
चङीअ	چڱيءَ
चङो	چڱو
चञो	چڱو
चट	چَٽَ
चट	چٽ
चटणु	چٽڻ
चटाईदार	چٽائيدار
चटाभेटी	چٽاڀيٽي
चटी	چٽي
चटु	چَٽُّ
चटु	چٽ
चट्णी	چٽڻي
चड़ती	چڙتي
चड़्हण	چڙھڻ
चड़्हणु	چڙھڻ
चड़्हणु	چڙهَڻُ
चड़्हणु	چڙهڻ
चड़्हाइणु	چڙھائڻ
चड़्हाई	اڳرائي
चड़्हाई	چاڙهي
चड़्हाई	چڙھائي
चड़्हाई	چَڙِھائِيِ
चड़्हाई	چَڙهائيِ
चड़्हियो	چڙيو
चड़्ही	چڙهي
चड़्हंदड़	چڙهندڙ
चड़्ह्यल	چڙهيل
चड़्ह्यल	ڇڙهيل
चती	چتي
चतुर	چتر
चतुराई	چترائي
चतूं	چتون
चथर	چٿر
चन्ब्राइणु	چَنبرائِڻُ
चपन	چپن
चपु	چپ
चपुटी	چپٽي
चप्टी	چپٽي
चप्रासी	چپراسي
चबूतिरो	چبوترو
चॿणु	چٻڻ
चॿाइणु	چٻائڻ
चॿाड़णु	چٻاڙڻ
चॿारणु	چٻارڻ
चॿिको	چٻڪو
चमक	چمڪ
चमत्कार	چمتڪار
चमत्कारी	چمتڪاري
चमत्कारु	چمتڪار
चमाट	چماٽ
चमिरो	چمرو
चमु	چم
चम्कणु	چمڪڻ
चम्काइणु	چمڪائڻ
चम्चो	چمچو
चम्ड़ा	چمڙا
चम्ड़ी	چمڙي
चम्ड़ीअ	چمڙيءَ
चम्ड़ो	چمڙو
चम्पल	چمپل
चम्बो	چمبو
चम्ब्रणु	چَمبرَڻُ
चयल	چيل
चयलु	چيل
चयाई	چيائي
चयो	چيو
चरस	چرس
चरितरहीण	چرترهين
चरित्रवान	چرتروان
चरियाई	چريائي
चरियो	چريو
चर्ख़	چرخ
चर्ख़ी	چرخي
चर्खी	چرکي
चर्खु	چرک
चर्चा	چرچا
चर्चाई	چرچائي
चर्चे	چرچي
चर्चेबाज़ी	چرچيبازي
चर्चो	چرچو
चर्णी	چرڻي
चर्ॿट्	چرٻٽ
चर्ॿी	چرٻي
चर्ॿीदार	چرٻيدار
चर्ॿीदार	چَرٻيِدار
चर्यन	چرين
चर्याइप	چريائپ
चर्याई	چريائي
चर्यो	چريو
चर्हणु	چرهَڻُ
चलाऊ	چلاءُ
चलाऊ	چلائو
चल्तेबाज़्	چلتيباز
चवण	چوڻ
चवणु	چوڻ
चवणु	چوڻُ
चवणु	چَوَڻُ
चवण्	چوڻ
चवाए	چوائي
चविणी	چوڻي
चव्णी	چوڻي
चश्केदार	چشڪيدار
चश्को	چشڪو
चश्मो	چشمو
चहकु	چهڪ
चहर	چهر
चहिबुकु	چهبڪ
चहिबुकु	چهبوڪ
चहिर	چهر
चहिरे	چھري
चह्कणु	چهڪڻ
चह्कु	چهڪ
चह्चिटो	چهچٽو
चह्बुक	چهبڪ
चह्बुकु	چهبڪ
चह्रे	چَھري
चाई	چائي
चाकु	چاڪ
चाकू	چاقوُ
चाची	چاچي
चाचो	چاچو
चाड़ीअ	چاڙيءَ
चाड़्हण	چاڙھڻ
चाड़्हणु	چاڙھڻ
चाड़्हणु	چاڙهڻ
चाड़्ही	چاڙھي
चाणो	چاڻو
चादर	چادر
चाद्रूं	چادرون
चाप्लूस	چاپلوس
चाप्लूस	چاپلوُس
चाप्लूस	چاپلوسي
चाप्लूसी	چاپلوسي
चाप्लूसी	چاپلوُسي
चाॿी	چاٻي
चारणु	چارڻ
चारो	چارو
चार्	چار
चार्नाचार	چارناچار
चार्हींदड़	چارهيندڙ
चाल	چال
चाल	چالَ
चाल	چڱل
चालक	چالاڪ
चालाक	چالاڪ
चालाकी	چالاڪي
चालाकीअ	چالاڪيءَ
चालाकु	چالاڪ
चालाक्	چالاڪ
चालाक्	چالاق
चालीह	چاليه
चालीहो	چاليهو
चालू	چالو
चालू	چالوُ
चाल्बाज़	چالباز
चाल्बाज़ी	چالبازي
चाश	چاش
चाह	چاھ
चाह	چاه
चाहण्	چاھڻ
चाहिणु	چاهڻ
चाहु	چاه
चाहु	چاهُ
चाहे	چاهي
चाह्	چاه
चाह्ना	چاھنا
चांउठि	چانئوٺ
चांटणु	ڇانٽڻ
चांदी	چاندي
चांवर	ڇانور
चांहि	چانه
चि^अ	چِڙَ
चिक	چڪ
चिक्नो	چڪنو
चिख्या	چکيا
चिख्या	چِکِيا
चिचिड़ु	چچڙ
चिची	چچي
चिच्रणु	چِچِرَڻُ
चिटणु	چٽڻ
चिटि	چٽ
चिटी	چٽي
चिटीअ	چٽيءَ
चिटो	چِٽو
चिटो	چٽو
चिट्की	چٽڪي
चिठी	چٺي
चिठो	چٺو
चिड़	چِڙَ
चिड़	چڙ
चिड़	چڙچڙو
चिड़णु	چڙڻ
चिड़िचिड़ो	چڙچڙو
चिड़ो	بد
चिड़्चिड़ो	چڙچڙو
चिड़्चिड़्यो	چڙچڙيو
चिड़्णो	چڙڻو
चिड़्यल	چڙيل
चिणिग	چڻگ
चिण्गारी	چڻگاري
चिण्गूं	چڻگون
चिता	چتا
चिताइणु	چتائڻ
चिताउ	چتاءُ
चितायु	چتاءُ
चिति	چِتِ
चित्र	چِتِرَ
चित्रकार	چترڪار
चित्रकारी	چترڪاري
चित्रु	چتر
चित्रु	چِتِرُ
चिथणु	چٿڻ
चिथर	چٿر
चिधो	چڏو
चिन्तन	چنتن
चिन्ताइक्	چنتائڪ
चिन्हु	چنه
चिप्कू	چپڪو
चिप्कंदड़	چپڪندڙ
चिप्चिपाहट	چپچپاهٽ
चिॿु	چٻ
चिम्कणु	چمڪڻ
चिम्काइणु	چمڪائڻ
चिम्कियल	چمڪيل
चिम्केदार	چمڪيدار
चिम्कंडड़	چمڪندڙ
चिम्कंदड़	چمڪندڙ
चिम्कंदड़्	چمڪندڙ
चिम्टी	چمٽي
चिम्ड़ो	چمڙو
चिम्नी	چمني
चिराग़्	چراغ
चिलाइणु	چلائڻ
चिल्को	چلڪو
चिल्कंदड़	چلڪندڙ
चिल्विलो	چلولو
चिंतन	چنتن
चिंता	چنتا
चिंबिड़ंदड़ु	چبڙندڙ
चीकी	چيڪي
चीको	چيڪو
चीक्लो	چيڪلو
चीचाट	چيچاٽ
चीट	چيٽ
चीड़्हालो	چيڙالو
चीड़्हालो	چيڙھالو
चीड़्हालो	چيڙهالو
चीड़्हु	چيڙه
चीतो	چيتو
चीनी	چيني
चीभाटणु	چيڀاٽڻ
चीरणु	چيرڻ
चीरु	چير
चील	چيِلَ
चीं	چين
चींभ	ڇينڀ
चुक	چڪ
चुक	ڀُلَ
चुकाइणु	چڪائڻ
चुकायल	چڪايل
चुक्तू	چُڪتوُ
चुग़िली	چغلي
चुग़ुलु	چغل
चुग़ुल्ख़ोर	چغلخور
चुॻणु	چڳڻ
चुॻुह्	چڳھ
चुघु	چگھ
चुप	چپ
चुपि	چپ
चुप्चाप	چپچاپ
चुभाइणु	چڀائڻ
चुभाइणु	چبائڻ
चुभंडड़	چبندڙ
चुभंदड़	چبندڙ
चुभ्को	چڀڪو
चुम्बक	چمبڪ
चुम्बकीय	چمبڪيي
चुर	چر
चुर	چُرَ
चुरंदड़	چرندڙ
चुर्च	چرچ
चुर्च	چُرچَ
चुर्पुर	چرپچ
चुल्ह	چله
चुल्ह्	چلھ
चुस्तु	چست
चुस्तु	چُستُ
चुहणु	چُھڻ
चुहणु	چھڻ
चुहणु	چهڻ
चुहिटंदड़्	چھٽندڙ
चुहिंड्ड़ी	چهندڙي
चुहिंड्ड़ी	چهنڊڙي
चुहिंब	چھنب
चुहंदड़	چهندڙ
चूड़ी	چوُڙيِ
चूड़ो	چوُڙو
चूपणु	چوپڻ
चूर	چور
चूरो	چورو
चूरो	چوُرو
चूसण	چوسڻ
चूसणु	چوسڻ
चूस्णी	چوسڻي
चूस्णो	چوسڻو
चूस्यल्	چوُسيل
चूहो	چوهو
चूं	چون
चूंगारणु	چونگارڻ
चूंगी	چونگي
चूंड	چونڊ
चूंड	چُونڊَ
चूंडणु	چونڊڻ
चूंडणु	چُونڊَڻُ
चूंडियलु	چونڊيل
चूंडींदड़्	چُونڊِيندَڙ
चेड़ाइणु	چيڙائڻ
चेड़ाईंदड़	چيڙائيندڙ
चेड़ाक	چيڙاڪ
चेड़ाक्	چيڙاڪ
चेड़्हणु	چيڙهڻ
चेत्ना	چيتنا
चेलो	چيلو
चेल्हि	چيله
चोखा	چوکا
चोग़ो	چوڳو
चोट	چوٽ
चोटी	چوٽي
चोड़णु	چوڙڻ
चोॾहां	چوڏهان
चोथाई	چوٿائي
चोथों	چوٿون
चोप्ड़ी	چوپڙي
चोर	چور
चोराइणु	چورائڻ
चोरायलु	چورايل
चोरी	چوري
चोरीअ	چوريءَ
चोरु	چور
चोंकी	چونڪي
चौकस	چوڪس
चौकीदार	چوڪيدار
चौकुंडो	چوڪنڊو
चौड़ाई	چوڙائي
चौड़ो	چوڙو
चौधारी	چوڌاري
चौपायो	چوپايو
चौपायो	چَوپايو
चौपेरो	چوپيرو
चौप्ड़ी	چوپڙي
चौरस	چورس
चौंकी	چونڪي
चौंकु	چونڪ
चंङी	چڱي
चंचल	چنچل
चंचल्	چنچل
चंचल्ट्~आ	چنچلتا
चंचल्ता	چنچلتا
चंड	چنڊ
चंडु	چنڊ
चंदन	چندن
चंदो	چندو
चंद्रमा	چندرما
चंद्रमा	ڇندرما
चंबिड़ंदड़	چنبڙندڙ
चंबेली	چنبيلي
चंबो	چنبو
च्टाई	چٽائي
छको	ڇڪو
छक्ड़ो	ڇڪڙو
छछुंदर	ڇڇندر
छॼह्री	ڇڄهري
छटणु	ڇٽڻ
छटार	ڇٽار
छटी	ڇٽي
छटु	ڇٽ
छट्पटाइणु	ڇٽپٽائڻ
छड़	ڇڙ
छड़ो	ڇڙو
छॾण	ڇڏڻَ
छॾणु	ڇَڏَڻُ
छॾणु	ڇڏڻ
छॾणु	ڇڏڻُ
छॾयल	ڇڏيل
छॾाइण	ڇڏائڻُ
छॾाइणु	ڇڏائڻ
छॾाइण्	ڇڏائڻ
छॾिणु	ڇڏڻ
छॾींदड़	ڇڏيندڙ
छॾे	ڇَڏي
छॾे	ڇڏي
छॾे	ڏيڻ
छण्कार	ڇڻڪار
छति	ڇت
छदणु	ڇڏڻ
छपरु	ڇپر
छपरु	ڇَپَرُ
छपाई	ڇپائي
छपायल	ڇپايل
छप्यल	ڇَپيَلَ
छप्रो	ڇپرو
छर	ڇر
छल	ڇل
छलु	ڇل
छलो	ڇلو
छल्कणु	ڇلڪڻ
छव	ڇو
छह	ڇه
छहु	چاه
छा	ڇا
छाकण	ڇاڪاڻ
छाकाण	ڇاڪاڻ
छाकाणि	ڇاڪاڻ
छाखूं	ڇاکون
छाछोलणु	ڇاڇولڻ
-छाड़	ڇاڙ
छाणणु	ڇاڻڻ
छाणी	ڇاڻي
छाणो	ڇاڻو
छाति	ڇات
छाती	ڇاتي
छाप	ڇاپ
छापण	ڇاپڻ
छापणु	ڇاپڻ
छापे	ڇاپي
छापो	ڇاپو
छाप्ख़ानो	ڇاپخانو
छाप्रू	ڇاپرو
छाया	ڇايا
छायादार	ڇايادار
छालाइ	ڇالاءِ
छांग	ڇانگ
छांट	ڇانٽ
छांडु	ڇانڊ
छांयल	ڇانيل
छांव	ڇانو
छांवेरो	ڇانويرو
छांहीं	ڇانهين
छिक	ڇڪ
छिकण	ڇڪڻ
छिकणु	ڇِڪَڻُ
छिकणु	ڇڪڻ
छिकताण	ڇڪتاڻ
छिकींदड़	ڇڪيندڙ
छिके	ڇڪي
छिक्यलु	ڇڪيل
छिछिड़ु	ڇِڇِڙُ
छिॼणु	ڇڄڻ
छिट्रो	ڇٽرو
छिडाई	ڇڊائي
छिड़िॿ	ڇڙٻ
छिडेरो	ڇڊيرو
छिडो	ڇڊو
छिड़्काइणु	ڇڙڪائڻ
छिड़्काउ	ڇڙڪاءُ
छिड़्ॿणु	ڇڙٻڻ
छिड़्विछिड़	ڇڙوڇڙ
छिण्कारु	ڇڻڪار
छिति	ڇت
छिति	ڇِتِ
छितो	ڇتو
छिनणु	چنڻ
छिनणु	ڇنڻ
छिनी	ڇني
छिनु	ڇن
छिप	ڇپ
छिप	ڇِپَ
छिपुनि	ڇپن
छिर्काइणु	ڇرڪائڻ
छिर्कु	ڇرڪ
छिलणु	ڇلڻ
छिलिड़ु	ڇلڙ
छिलु	ڇِلُ
छिल्को	ڇلڪو
छिल्कोन्	ڇلڪو
छिंभ	ڇنڀ
छी	ڇي
छींभणु	ڇينڀڻ
छींभणु	ڇيِنڀَڻُ
छुॻो	ڇڳو
छुटणु	ڇٽڻ
छुटल	ڇُٽَل
छुटल्	ڇٽل
छुटिकारो	ڇٽڪارو
छुटी	ڇوٽي
छुटी	ڇٽي
छुट्कारे	ڇوٽڪاري
छुट्कारो	ڇٽڪارو
छुड़्वाॻ	ڇڙواڳ
छुड़्वाॻी	ڇِڙواڳي
छुपी	ڇپي
छुरी	ڇري
छुरो	ڇرو
छुहण	ڇُهَڻَ
छुहणु	ڇھڻ
छुहणु	ڇهڻ
छुहो	ڇهو
छुहंदड़	ڇهندڙ
छूट	ڇوٽ
छूत	ڇوت
छूत्	ڇوت
छेकु	ڇيڪ
छेड़	ڇيڙ
छेड़णु	ڇيڙڻ
छेड़ो	ڇيڙو
छेड़्छाड़	ڇيڙڇاڙ
छेणी	ڇيڻي
छेणो	ڇيڻو
छेति	ڇيت
छेदु	ڇيد
छेरु	ڇيڙ
छेलो	ڇيلو
छो	ڇو
छोकर्पिणो	ڇوڪرپڻو
छोक्ड़ी	ڇوڪِڙيِ
छोक्र	ڇوڪر
छोक्राटु	ڇوڪراٽ
छोक्रानो	ڇوڪرانو
छोक्री	چوڪري
छोक्री	ڇوڪري
छोक्रीअ	ڇوڪري
छोक्रे	ڇوڪري
छोक्रो	ڇوڪرو
छोटि	ڇوٽِ
छोटिकारो	ڇوٽڪارو
छोट्कारो	ڇوٽڪارو
छोट्को	ڇوٽڪو
छोड़णु	ڇوڙڻ
छोॾे	ڇوڏي
छोॾो	ڇوڏو
छोली	ڇولي
छोलू	ڇولو
छंछरु	ڇنڇر
छंड	ڇنڊ
छंड	ڇند
छंडा	ڇنڊا
छंडो	ڇنڊو
छंदु	ڇند
ज़ईफ़	زعيف
ज़ईफ़ु	ضعيف
जकड़	جڪڙ
ज़ख़म	زخم
ज़ख़मु	زخم
ज़ख़्मी	زخمي
जॻ	جڳ
जॻतु	جڳت
जॻमॻाइणु	جڳمڳائڻ
जॻमॻाईंदड़्	جڳمڳائيندڙ
जॻह	جڳھ
जॻह	جڳه
जॻहि	جڳھ
जॻह्	جڳھ
जॻह्	جڳه
जॻाइणु	جڳائڻ
जॻाईंदड़	جڳائيندڙ
जजु	جج
जज़्बात	جذبات
जज़्बे	جزبي
जज़्बो	جَذبو
जटाउ	جٽاءُ
जटाउ	جَتاءُ
जड़	جڙ
जड़णु	جڙڻ
जड़त	جڙت
जड़ी	جڙي
जड़्	جڙ
जड़्ता	جڙتا
जड़्वाद	جڙواد
जॾहिं	جڏهن
जॾो	جڏو
जतन	جتن
जथो	جٿو
जनक	جنڪ
जनत	جَنَت
जनम	جنم
जनम्पत्री	جنمپتري
ज़नानो	زنانو
ज़नानो	زَنانو
जन्गी	جَنگيِ
जन्ता	جنتا
जन्मी	جنمي
ज;न्हिं	جَنهِن
जफ़ाकशी	جفاڪشي
ज़बर्दस्त	زبردست
ज़बर्दस्ती	زبردستي
ज़बर्दस्तीअ	زبردستيءَ
जबलु	جبل
ज़बान	زبان
ज़बान	هلائڻ
ज़बानी	زباني
ज़ब्त	ضبت
ज़ब्त	ضبط
ज़ब्ती	ضبتي
ज़ब्ती	ضبطي
ज़ब्तु	ضبط
जब्रो	جبرو
ज़म	ذم
जमा	جمع
जमाइत	جمائت
ज़मान	زمان
ज़मानत्दार	ضمانتدار
ज़माने	زماني
ज़मानो	زمانو
ज़मानो	زَمانو
जमीअत्	جميعت
ज़मीन	زمين
ज़मीनदोज़	زميندوز
ज़मीन्	زمين
ज़मीन्दार्	زميِمدار
ज़मीन्दोज़	زميندوز
ज़मीमो	ضميمو
ज़मीर्	ضمير
ज़मींदार	زميندار
ज़मींदारी	زمينداري
जमौ	جمع
ज़ररु	ضرور
ज़रर्नाक	زررناڪ
ज़रिड़ो	ذرڙو
ज़री	زري
ज़री	زريِ
ज़रूर	ضرور
ज़रूर	ضَروُر
ज़रूरत	ضرورت
ज़रूरतूं	ضرورتوُن
ज़रूरत्	ضَرورَت
ज़रूरी	ضروري
ज़रूरु	ضرور
ज़रूर्	ضرور
ज़रे	ذري
ज़रो	ذرو
ज़रो	ذَرو
ज़र्दु	زرد
ज़र्ब	ضرب
जर्मनी	جَرمَنيِ
जलाइण	جلائڻ
जलाऊ	جلائو
जलाद	جلاد
जलावतनी	جلاوطني
जलु	جل
जलूस	جلوس
जल्द	جلد
जल्दी	جلدي
जल्दी	جَلدي
जल्दु	جلڊ
जल्दु	جلد
जल्द्बाज़ी	جلدبازي
जल्द्बाज़्	جلدباز
जल्परी	جلپري
जल्वे	جلوي
जल्वो	جلوو
जल्सो	جلسو
जल्सो	جَلِسو
जव	جو
जव	جَوَ
जवन	جون
जवानी	جواني
जवानु	جوان
जवाब	جواب
जवाबी	جوابي
जवाबु	جواب
जवाब्	جواب
जवाब्दार	جوابدار
जवाब्दारी	جوابداري
जवाब्दारीअ	جوابداري
जवाब्दार्	جوابدار
ज़वालियत्	زواليت
जवाहरि	جواھري
जवाहर्	جواھر
जवाहिर	جواهر
जवाह्रात्	جواھرات
जशन	جشن
जशन्	جشن
जसाइतो	جسائتو
जसु	جس
ज़हनु	زهن
ज़हरु	زهر
जहाज़	جھاز
जहाज़	جهاز
जहाज़न	جھازن
जहाज़न	جهازن
जहाज़ी	جھازي
जहाज़ी	جهازي
जहाज़ु	جهاز
जहाज़्	جَهاز
जहाज़्रानी	جهازراني
जहान	جهان
जहिड़ाई	جهڙائي
जहिड़ी	جهڙي
जहिड़ो	جهڙو
जहिड़ो	جَهِڙو
जहिड़ो	جَھڙو
जहिड़ो	جھڙو
ज़हिरी	زهري
जहिं	جنھن
जहिं	جنهن
जहिं	جهن
ज़हीन	ذهين
जह्ड़ा	جھڙا
जह्ड़ी	جھڙي
जह्ड़ो	جهڙو
जह्ड़ो	جَھڙو
जह्ड़ो	جھڙو
ज़ह्री	زهري
ज़ह्रीलो	زهريلو
जह्रोक्:	جَهروڪ
जा	جا
जाइ	جاء
जाइ	جاءِ
ज़ाइकेदार	ذائقيدار
ज़ाइको	ذائقو
जाइज़	جائز
जाइज़ु	جائِز
जाइज़्	جائز
जाइदाद	جائداد
जाइदाद	جائِداد
ज़ाइफ़ा	زاعفا
जाए	جائي
जागीर	جاگير
जाॻ	جاڳ
जाॻणु	جاڳڻ
जाॻयलु	جاڳيل
जाॻाइणु	جاڳائڻ
जाॻिर्ता	جاڳرتا
जाॻु	جاڳُ
जाच	جاچ
जाच	جاچَ
जाचणु	جاچَڻُ
जाचणु	جاچڻ
जाचींदड़	جاچيندڙ
जाचे	جاچي
ज़ाटि	ذاتِ
ज़ाट्यो	ذاتيو
जाड़ो	جاڙو
जाणि	جاڻ
ज़ात	ذات
ज़ाति	ذات
ज़ाति	زات
जाती	جاتي
ज़ाती	ذاتي
ज़ाती	ذاتيِ
ज़ाती	زاتي
जातीअ	جاتيَ
ज़ात्	ذات
जादु	جادو
जादू	جادو
जादू	جادوَ
जादूगर	جادوگر
जादूगरिणि	جادوگرڻ
जादूगरी	جادوگري
जान	جان
जानि	جان
जानी	جاني
जान्wअर	جانور
जान्बाज़	جانباز
जान्वरन	جانورن
जान्वरनि	جانورن
जान्वर्	جانور
ज़ाब्ते	ضابطي
ज़ाब्तो	ضابطو
जाब्लू	جابلو
जाब्लू	جابلوُ
जाम	جام
जाम	جامَ
ज़ामिन	ضامن
ज़ामिनु	ضامن
जामेट्री	جاميٽِريِ
जामो	جامو
जाम्	جام
जारी	جاري
ज़ाल	زال
जालन्	جالن
ज़ालपिणु	زالپڻ
ज़ालाणो	زالاڻو
ज़ालिम	ظالم
ज़ालूं	زالون
जाल्साज़ी	جالسازي
जावित्री	جاوتري
जासूद	جاسود
जासूस	جاسوس
जासूस	جاسُوس
जासूसु	جاسوس
जासूस्	جاسوس
ज़ाहिर	ظاھر
ज़ाहिर	ظاهر
ज़ाहिर	ظاهِر
ज़ाहिराई	ظاھرائي
ज़ाहिरी	ضاهري
ज़ाहिरी	ظاھريِ
ज़ाहिरी	ظاهري
ज़ाहिरु	ظاھر
ज़ाहिरूं	ظاهرون
ज़ाहिर्	ظاھر
जाहिली	جاهلي
जाहिल्	جاھل
जांठो	جانٺو
जिअं	جئن
ज़िक्रु	ذڪر
जिगरी	جگري
जिग्री	جگري
जिॻयासा	جڳياسا
जिॻयासू	جڳياسو
जितां	جتان
जिते	جتي
ज़िदी	ضدي
ज़िदु	ضد
ज़िनाउ	زناءُ
जिनिखे	جنکي
जिनु	جن
ज़िڱन्दगी	زندگي
ज़िन्दादिल	زندادل
जिन्स	جنس
जिन्स	جِنِسَ
जिन्सी	جنسي
जिन्स्यत	جنسيت
ज़िबानु	زبان
ज़िमेदार	ذميدار
ज़िमेदारी	ذميواري
ज़िमेदारी	ضِميداريِ
ज़िमेवार	ذميوار
ज़िमो	ذمو
ज़ियादा	زيادا
ज़ियान	زيان
ज़ियान	ضيان
जियापो	جياپو
जियारणु	جيارڻ
ज़िरह	ظِرَه
ज़िलो	ضلعو
ज़िल्ज़िलो	ذلذلو
ज़िल्ज़िलो	زلزلو
जिस्त	جِستَ
जिस्त	جِستُ
जिस्मानी	جسماني
ज़िंदा	زندا
ज़िंदादिल	زندادل
ज़िंदादिल	زندهدل
जिंदु	جند
जिंस	جنس
जी	انگور
जी	جي
जी	جيِ
जी	ڇوڪري
जीअणु	جيئڻ
जीअरी	جيئري
जीअरे	جيئري
जीअरो	جيئرو
जीअरो	جيئَرو
जीअं	جيئن
जीअं	جيئَن
जीआलो	جيئالو
जीत	جيت
जीतण	جيتڻ
जीतणु	جيتڻ
जीतु	جيت
ज़ीन	زينذ
ज़ीरकु	زيرڪ
जीरो	جيرو
जीव	جيو
जीवन	جيون
जीवनी	جيِوَنيِ
जीवनु	جيون
जीवाणू	جيواڻو
जीवित्	جيوت
जीवु	جيو
जीव्	جيو
जीव्ड़न	جيوڙن
जीव्ड़ा	جيوڙا
जीव्ड़ो	جيوڙو
जीव्णी	جيِوڻيِ
जुआरी	جوئاري
ज़ुकाम्	زڪام
जुॻाए	جڳائي
जुज़ा	جزا
जुज़ा	جُزا
जुज़ो	جزو
जुज़ो	جُزو
जुज़्वी	جزوي
जुटाइणु	جٽائڻ
जुठ	جٺ
जुठि	جٺ
जुड़्जणु	جڙجڻ
जुड़्तू	جُڙتوُ
जुड़्तू	جڙتو
जुड़्यल	جڙيل
जुड़्यलु	جڙيل
जुत	جت
जुती	جتي
जुथो	جٿو
जुदा	جدا
जुदा	جُدا
जुदाई	جدائي
जुदाई	جُدائِي
जुनून	جنون
जुनूनी	جنوني
जुनून्	جنون
ज़ुबान	زبان
ज़ुबानी	زباني
जुमो	جمعو
जुम्ले	جملي
जुम्लो	جملو
जुरिअत	جريت
जुरियत्	جريت
जुर्यत	جريت
जुलाबु	جلاب
ज़ुलुम	ظلم
जुलूस	جلوس
जुल्द	جُلِدُ
जुल्दु	جلد
ज़ुल्म	ظلم
ज़ुल्मु	ظلم
ज़ुल्म्	ظلم
जुवा	جوا
जुवानिड़ी	جوانڙي
जुवानीअ	جوانيءَ
जूअरि	جوئر
जूआ	جوئا
जूआरी	جوئاري
जूखो	جوکو
जूच	جوچ
जूठि	جوٺ
जूरी	جوري
जूरीअ	جوريءَ
जूलाहो	جولاهو
जूं	جون
जे	جي
जे	جيِ
जेकॾहिं	جيڪڏهن
जेकर	جيڪر
जेकस	جيڪس
जेकी	جيڪي
जेको	جيڪو
जेॾा	جيڏا
जेॾाहुं	جيڏاهن
जेॾांहुं	جيڏانهن
जेॾो	جيڏو
ज़ेतून	زيتون
जेतोणीक	جيتوڻيڪ
जेतोणीक्	جيتوڻيڪ
जेत्रे	جيتري
जेत्रो	جيترو
जेब	جيب
जेरो	جيرو
ज़ेरोक्स	زيروڪس
ज़ेर्ज़मीन	ذيرزمين
ज़ेर्तज्वीज़	زيرتجويز
ज़ेर्दस्ट्	زيردست
ज़ेर्दस्त	زيردست
ज़ेर्दस्ती	زيردستي
जेल	جيل
जेलर	جيلر
जेल्	جيل
ज़ेवर	زيور
जेसिताईं	جيستائين
जेसीं	جيسين
जेस्ताईं	جيستائين
जेह्ड़ा	جھڙا
जैकेट्	جَئِڪيٽ
ज़ैफ़्रान	زعفران
जैहिड़ो	جھڙو
जो	جو
जो	هوا
जो	يا
जोइ	جوءِ
जोखम	جوکم
जोख़ाइतो	جوخائتو
जोखाइतो	جوکائتو
जोखे	جوکي
जोखो	جوکو
जोॻाई	جوڳائي
जोॻाई	جوڳائيِ
जोॻी	جوڳي
जोॻो	جوڳو
जोड़	جوڙ
जोड़णु	جوڙڻ
जोड़ी	جوڙي
जोड़ीदार	جوڙيدار
जोड़ीदार्	جوڙيدار
जोड़ींदड़	جوڙيندڙ
जोड़ु	جوڙ
जोड़ो	جوڙو
जोड़्	جوڙ
जोड़्जक	جوڙجڪ
जोड़्जक	جوڙجڪا
जोतिश	جوتش
जोतिश	جوتِش
जोती	جوتي
जोधो	جوڌو
जोभनु	جوڀن
ज़ोर	ذور
ज़ोर	زور
जोरणु	جوڙڻ
जोराबु	جوراب
जोराबु	راب
ज़ोरीअ	زوريءَ
ज़ोरु	زور
ज़ोर्दार	زوردار
ज़ोर्दार्	زوردار
जोश	جوش
जोश	جوشَ
जोशाइतो	جوشائتو
जोशीलो	جوشيلو
जोशीलो	جوشيِلو
जोशु	جوش
जोशु	جوشُ
जोश्	جوش
जौह्री	جوھري
जंग	جنگ
जंग	جَنگ
जंगि	جنگ
जंगी	جنگي
जंगी	جَنگيِ
ज़ंगु	زنگ
ज़ंजीर	زنجير
जंड	جنڊ
जंडी	جنڊي
जंता	جنتا
जंहिं	جنهن
जंहिं	جَنهِن
ज़्आहिर	ظاهر
ज्झंग	جھنگ
ज़्नान्ख़ानो	زنانخانو
ज़्यानु	زيان
ज्वानी	جواني
ज्वान्	جوان
ज्वान्ड़ी	جوانڙي
ज्वान्ड़ो	جوانڙو
ज्वाला	جوالا
ज्वालामुखी	جوالامکي
ॼण	ڄڻ
ॼणणु	چَڻَڻُ
ॼणु	ڃڻ
ॼणे	ڄڻي
ॼमणु	ڄمڻ
ॼमणु	ڄَمَڻُ
ॼमाइणु	ڄمائڻ
ॼमाईंदड़	ڄمائيندڙ
ॼमियल	ڄميل
ॼमियल्	ڄميل
ॼमी	ڄمي
ॼमु	ڄَمُ
ॼाउ	ڄاءُ
ॼाड़ी	ڄاڙي
ॼाण	ڄاڻ
ॼाणणु	ڄاڻڻ
ॼाणाइणु	ڄاڻآئڻ
ॼाणाइणु	ڄاڻائڻ
ॼाणी	ڄاڻي
ॼाणु	ڄاڻُ
ॼाणू	ڄاڻو
ॼाणू	ڄاڻوُ
ॼाण्	ڄاڻ
ॼातलु	ڄاتل
ॼातल्	ڄاتل
ॼाम्ड़ो	ڄامڙو
ॼाम्फल	ڄامڦل
ॼारी	ڄاري
ॼारीदार	ڄاريدار
ॼारु	ڄار
ॼारो	ڄارو
ॼावल	ڄاول
ॼिभ	ڄڀ
ॼिभी	ڄڀي
ॼौर	ڄَور
झक	جھڪ
झकाई	جھڪائي
झकाईअ	جھڪائيءَ
झकी	جھڪي
झको	جھڪ
झको	جھَڪو
झको	جھڪو
झॻड़ालू	جڳڙالو
झॻड़ालू	جھڳڙالو
झॻड़ो	جھَڳِڙو
झॻड़ो	جھڳڙو
झॻिड़णु	جهڳڙڻ
झझाई	جھجھائي
झझो	جَھجھو
झझो	جھجھو
झट	جھٽ
झट	جهٽ
झटणु	جھٽڻ
झटि	جھٽ
झटिकणु	جھٽڪڻ
झट्के	جھٽڪي
झट्को	جھٽڪو
झट्पट	جھٽپٽ
झट्पट्	جھٽپٽ
झपणु	جھپڻ
झपु	جھپ
झपो	جھپو
झप्की	جھپڪي
झप्टणु	جھپٽڻ
झप्टो	جھپٽو
झर्णो	جھرڻو
झल	جھل
झलक	جھلڪ
झलक	جھَلَڪ
झलण	جھَلَڻَ
झलणु	جھلڻ
झलु	جھَلُ
झल्कणु	جھلڪڻ
झल्को	جھلڪو
झल्कंदड़	جھلڪندڙ
झाको	جھاڪو
झाटो	جھاٽو
झाड़	جھاڙ
झाड़	جھار
झाड़ूअ	جھاڙوءَ
झाती	جھاتي
झालर	جھالر
झालू	جھالو
झिझक	جھجھڪ
झिझिकणु	جھجھڪڻ
झिर्की	جھرڪي
झिर्कु	جھرڪ
झिली	جھلي
झिल्मिलाइणु	جھلملائڻ
झीणो	جھيڻو
झींगो	جھينگو
झुकण	جھڪڻ
झुकणु	جھڪڻ
झुकाई	جھڪائي
झुकाउ	جھڪاءُ
झुकियल्	جھڪيل
झुक्यलु	جھڪيل
झुक्यल्	جھڪيل
झुॻटो	جھڳٽو
झुड़ालो	جھڙالو
झुन्ड	جھُنڊَ
झुलणु	جلڻ
झुंझिलाइट	جھنجھلائٽَ
झुंडु	جھنڊ
झूटा	جھوٽا
झूटो	جو
झूटो	جھوُٽو
झूटो	جھوٽو
झूनो	جھونو
झूप्ड़ी	جھوپڙي
झूर्	جھور
झूलणु	جھولڻ
झूलो	جھولو
झेड़ो	جھيڙو
झोपड़्पटी	جھوپڙپٽي
झोॿो	جھوٻو
झोलु	جھول
झंगलु	جھنگل
झंगल्	جھنگل
झंगु	جھنگ
झंग्ली	جھنگلي
झंग्लीपिणो	جھنگليپڻو
झंघु	جھَنگھُ
झंझट	جھنجھٽ
झंडो	جھنڊو
ञाणू	ڄاڻو
टकरु	ٽڪر
टकिरणु	ٽڪرڻ
टकिराएजी	ٽڪرائجي
टकु	ٽڪ
टकुली	ٽڪلي
टक्रणु	ٽَڪِرَڻُ
टक्रणु	ٽڪرڻ
टक्राइणु	ٽڪرائڻ
टक्री	ٽڪري
टक्रु	ٽڪر
टक्साल	ٽڪسال
टपणु	ٽپڻ
टपरणु	ٽپرڻ
टपाल	ٽپال
टपो	ٽپو
टमाटो	ٽماٽو
टरह	طرح
टल्wआर	تلوار
टहकु	ٽهڪ
टहिकणु	ٽهڪڻ
टहिकाइणु	ٺھڪائڻ
टह्काइणु	ٽهڪائڻ
टह्कु	ٽھڪ
टह्को	ٽھڪو
~टह्ड़ा	تھڙا
टाईप	ٽائيپ
टाको	ٽاڪو
टाकोर	ٽاڪور
टाक्रू	ٽاڪرو
टाचिनी	ٽاچني
टाड़े	ٽاڙي
टामो	ٽامو
टायरु	ٽاير
टारणु	ٽارِڻُ
टारणु	ٽارڻ
टारी	ٺاري
टारींदड़	ٽاريندڙ
टारो	ٽارو
टाल	ٽال
टावर	ٽاور
टाहु	ٽاه
टांइ	ٽائِن
टांकी	ٽانڪي
टांडे	ٽانڊي
टांडो	ٽاَنڊو
टिएं	ٽئين
टिक	ٽِڪِ
टिक	ٽڪ
टिकण	ٽِڪَڻَ
टिकणु	ٽڪڻ
टिकाउ	ٽڪاءُ
टिकाऊ	ٽڪاءُ
टिकाणो	ٽڪاڻو
टिकी	ٽڪي
टिकुंडो	ٽڪنڊو
टिकेट	ٽڪيٽ
टिको	ٽڪو
टिकंदड़्	ٽڪندڙ
टिजोड़ी	تجوڙي
टिटु	ٽِٽُ
टिड़णु	ٽڙڻ
टिड़्यल	ٽڙيل
टिड़्यल्	ٽڙيل
टिन्टिन	ٽنٽن
टिपणु	ٽپڻ
टिपा	ٽِپا
टिपाई	ٽپائي
टिपु	ٽپ
टिपो	ٽپو
टिपंदो	ٽپندو
टिफ़िन	ٽفن
टिमणु	ٽمڻ
टिमाइणु	ٽمائڻ
टिम्कणु	ٽمڪڻ
टियाई	ٽيائي
टियों	ٽيون
टिशू	ٽشو
टिहर	ٽهر
टीका	ٽيڪا
टीकाकार्	ٽيڪاڪار
टीट	ٽيٽ
टीणि	ٽيڻ
टीणो	ٽيڻو
टीनु	ٽين
टीह	ٽيه
टुकणु	ٽڪڻ
टुकर	ٽڪر
टुकरु	ٽڪر
टुका	ٽڪا
टुकिर्युन	ٽڪرين
टुकुर	ٽڪر
टुक्ड़ा	ٽڪڙا
टुक्ड़ो	ٽڪڙو
टुक्रा	ٽڪرا
टुक्राटो	ٽڪراٽو
टुक्रो	ٽُڪرو
टुक्रो	ٽڪرو
टुट	ٽُٽَ
टुटणु	ٽُٽَڻُ
टुटणु	ٽٽڻ
टुटल	ٺٺل
टुटी	ٽٽي
टुफ़ंग्	تقنگ
टुॿिको	ٽٻڪو
टुॿी	ٽٻي
टुवालु	ٽوال
टुंग	ٽنگ
टुंगु	ٽنگ
टुंडो	ٽنڊو
टुंबणु	ٽنبڻ
टुंबाइणु	ٽنبائڻ
टे	تي
टे	ٽي
टेक	ٽڪ
टेक	ٽيڪ
टेगॾु	ٽيگڙ
टेज़	تيز
टेॾो	ٽيڏو
टेंडर	ٽينڊر
टोक	ٽوڪ
टोकणु	ٽوڪڻ
टोकाइतो	ٽوڪائتو
टोक्बाज़ी	ٽوڪبازي
टोक्री	ٽوڪري
टोटो	ٽوٽو
टोट्काई	ٽوٽڪائي
टोट्को	ٽوٽڪو
टोड	ٽوڊ
टोड़	ٽوڙ
टोड़णु	ٽوڙڻ
टोनो	ٽونو
टोपणु	ٽوپڻ
टोपी	ٽوپي
टोपो	ٽوپو
टोप्लो	ٽوپلو
टोर	ٽور
टोरे	ٽوڙي
टोली	ٽولي
टंग	ٽنگ
टंगणु	ٽنگڻ
टंग्यल	ٽنگيل
टंटो	ٽنٽو
ट्यूब	ٽيوب
ट्रस्टी	ٽرسٽي
ट्वारीख़	تواريخ
ठकलु	ٿڪل
ठकाउ	ٺڪاءُ
ठॻणु	ٺڳڻ
ठॻी	ٺَڳي
ठॻी	ٺڳي
ठॻी	ٺڳيِ
ठॻींदड़ु	ٺڳيندڙ
ठॻु	ٺڳ
ठठोली	ٺَٺوليِ
ठठोली	ٺٺولي
ठपणु	ٺپڻ
ठपो	ٺپو
ठर्यलु	ٺريل
ठल्हाई	ٺَلهائيِ
ठह	ٺه
ठहणु	ٺهڻ
ठहिकणु	ٺھڪڻ
ठहिकणु	ٺَهِڪَڻُ
ठहियलु	ٺهيل
ठहिराइणु	ٺھرائڻ
ठहिराइणु	ٺهرائڻ
ठहिराउ	ٺهراءُ
ठही	ٺهي
ठहंदड़्	ٺھندڙ
ठहंदो	ٺهندو
ठह्काइणु	ھهڪائڻ
ठह्कंदड़	ٺهڪندڙ
ठह्कंदड़्	ٺَهڪَندَڙ
ठह्कंदर	ٺَهِڪَندَر
ठह्यल	ٺهيل
ठह्यल	ٺھيل
ठह्राइणु	ٺھرائڻ
ठह्राइणु	ٺَهرائڻُ
ठह्राउ	ٺهراءُ
ठह्रायलु	ٺَهِرايَلُ
ठाइणु	ٺائڻ
ठाक	ٺاڪ
ठाठ	ٺاٺ
ठाठु	ٺاٺ
ठापणु	ٺاپڻ
ठापुर	ٺاپر
ठारणु	ٺارڻ
ठाह	ٺاھ
ठाह	ٺاه
ठाहिणु	ٺاھڻ
ठाहिणु	ٺآهڻ
ठाहिणु	ٺاهِڻ
ठाहिणु	ٺاهِڻُ
ठाहिणु	ٺاهڻ
ठाहियल्	ٺاھيل
ठाहिं~उ	ٺائڻ
ठाहींदड़	ٺاهيندڙ
ठाहींदड़	ٺاھيندڙ
ठाहींदड़्	ٺاهيندڙ
ठाहींद्ड़	ٺاهيندڙ
ठाहु	ٺاھ
ठाहु	ٺاه
ठाहूकाई	ٺاهوڪائي
ठाहूको	ٺاهوڪو
ठाहूको	ٺاھوڪو
ठाहे	ٺاهي
ठाह्यलु	ٺاهيل
ठिकर	ٺِڪَرَ
ठिकर	ٺڪر
ठिकाणो	ٺڪاڻو
ठिठोली	ٺٺولي
ठियणु	ٿيڻ
ठि~यणु	ٿِيَڻُ
ठीक	ٺيڪ
ठीको	ٺيڪو
ठुक्यल	ٺڪيل
ठुक्राइणु	ٺڪرائڻ
ठुड़्को	ٺڙڪو
ठूक	ٺوڪَ
ठूसणु	ٺوسڻ
ठूह	ٺوھ
ठूह	ٺوه
ठूह्	ٺوھ
ठूंठि	ٺوُنٺ
ठूंठो	ٺونٺو
ठेह्राइणु	ٺھرائڻ
ठेह्रायल्	ٺھرايل
ठेंग	ٺيِنگَ
ठैकणु	ٺئڪڻ
ठैराइणु	ٺھرائڻ
ठोकणु	ٺوڪڻ
ठोकर	ٺوڪر
ठोठि	ٺوٺي
ठोड़्हो	ٺوڙهو
ठोस	ٺوس
ठौंशो	ٺونشو
ठ्यणु	ٿيڻ
ठ्हॻी	ٺڳي
ठ्हाइणु	ٺھائڻ
डपाइतो	ڊپائتو
डपु	ڊپ
डबू	ڊبو
डॿरोटी	ڊٻرروٽي
डॿरोटीअ	ڊٻروٽيء
डॿाइणु	دٻائڻ
डर्सनी	درسني
डहणु	ڊھڻ
डहिको	دهڪو
डाक	ڊاڪ
डाकू	ڊاڪو
डाक्टर	ڊاڪٽر
डाक्ट्री	ڊاڪٽري
डाख	ڊاک
डाग़ु	داغ
डाह	ڊاھَ
डाहिणु	ڊاھڻ
डाहिणु	ڊاهِڻُ
डाहिणु	ڊاهڻ
डांवा	ڊانوا
डांवाडोल	ڊانواڊول
डांवाडोल	ڊڱنواڊول
डांवां	ڊانوان
डांवांडोल	ڊانوانڊول
डांवांडोल	ڊانواڊول
डिक्शिनरी	ڊڪشنري
डिघाई	ڊگھائي
डिघी	ڊگھي
डिघेरणु	ڊگھيرڻ
डिघो	دگھو
डिघो	ڊگھو
डिॼणु	ڊڄڻ
डिॼणो	ڊڄڻو
डिॼिणो	ڊڄڻو
डिॼी	ڊڄي
डिढु	ڊڍ
डिढ्हु	ڊڍ
डिॿिड़	ڊٻر
डि^यणु	ڏيڻ
डिल	دل
डीठ	ڊيٺ
डुक	ڊڪ
डुकणु	ڊڪڻ
डुकी	ڊڪي
डुकंदड़	ڊڪندڙ
ड़े	ڙي
डेघ	ڊيگھ
डेघि	ڊيگھ
डेघ्	ڊيگھ
डेॼाईंदड़	ڊيڄائيندڙ
डेॼारणु	ڊڄارڻ
डेॼारणु	ڊيڄارڻ
डेॼो	ڊيڄو
डोखो	دوکو
डोड़	ڊوڙ
डोड़णु	ڊوڙڻ
डोड़ाइणु	ڊوڙائڻ
डोरणु	ڊورڻ
डोल	ڊول
डौरु	دور
डौल	ڊول
डौलाइतो	ڊولائتو
डौलु	ڊَول
डंगु	ڍنگ
ॾई	ڏئي
ॾकणु	ڏڪڻ
ॾकाइणु	ڏڪائڻ
ॾक्णी	ڏڪڻي
ॾखण	ڏکڻ
ॾखणु	ڏکڻ
ॾटोमुटो	ڏٽڏمٽو
ॾटोमुटो	ڏٽومٽو
ॾॾु	ڏڏ
ॾढु	ڏڍ
ॾन्द	ڏند
ॾन्दु	ڏندُ
ॾन्दो	ڏندو
ॾमरु	ڏمر
ॾमिर्यल	ڏمريل
ॾयण	ڏيڻ
ॾयणु	ڏِيَڻ
ॾयणु	ڏِيَڻُ
ॾयणु	ڏيَڻُ
ॾयणु	ڏيڻ
ॾयारणु	ڏيارَڻُ
ॾयारणु	ڏيارِڻُ
ॾयारणु	ڏيارڻ
ॾयारींदड़	ڏياريندڙ
ॾयारींदड़	ڏِياريِندَڙ
ॾयारींदड़	ڏيارينديڙ
ॾयारे	ڏياري
ॾरु	ڏر
ॾसिणी	ڏسڻي
ॾसींदड़	ڏسيندڙ
ॾसु	ڏس
ॾसु	ڏَسُ
ॾह	ڏھ
ॾह	ڏه
ॾह	ڏَهَ
ॾहाईन्	ڏھائين
ॾहाको	ڏھاڪو
ॾही	ڏھي
ॾहें	ڏھين
ॾहों	ڏهون
ॾह्काइणु	ڏهڪائڻ
ॾह्काउ	ڏهڪاءُ
ॾाइणि	ڏائڻ
ॾाओ	ڏائو
ॾाकणि	ڏاڪڻ
ॾाकण्	ڏاڪڻ
ॾाको	ڏاڪو
ॾाखिणो	ڏاکڻو
ॾाख्ड़ो	ڏاکڙو
ॾाजो	ڏاج
ॾाड़्ह	ڏاڙه
ॾाड़्हणु	ڏاڙهڻ
ॾाड़्ही	ڏاڙهي
ॾाड़्ही	ڏاڙھي
ॾाड़्हूं	ڏاڙهون
ॾाॾाणो	ڏاڏاڻو
ॾाॾी	ڏاڏي
ॾाॾो	ڏاڏو
ॾाढाई	ڏاڍائي
ॾाढाईअ	ڏاڍائيءَ
ॾाढो	ڏاڍو
ॾात	ڏات
ॾानासिरो	ڏاناسرو
ॾामर	ڏامر
ॾामरु	ڏامر
ॾार	ڏار
ॾारु	ڏار
ॾारु	دور
ॾाहप	ڏاھپ
ॾाहप	ڏاهپ
ॾाहो	ڏاهو
ॾांउ	ڏانءُ
ॾांडारी	ڏانڊاري
ॾांडी	ڏانڊي
ॾांद	ڏاند
ॾांह	ڏان
ॾांहुं	ڏانهن
ॾिॼंदड़	ڊڄندڙ
ॾिठल	ڏٺل
ॾिठे	ڏِٺي
ॾिणु	ڏڻ
ॾिनल	ڏنل
ॾिनल	ڏِنَلُ
ॾिनलु	ڏنل
ॾिनल्	ڏنل
ॾिन्गो	ڏنگو
ॾिन्गो	ڏِنگو
ॾियण	ڏيڻ
ॾियणु	اڪيلو
ॾियणु	ڪرڻُ
ॾियणु	ڏِيَڻُ
ॾियणु	ڏِيِڻُ
ॾियणु	ڏِيڻُ
ॾियणु	ڏيڻ
ॾियणु	ڏيڻُ
ॾियणु	يا
ॾियणुव्	ڏيڻوي
ॾियण्	ڏيڻ
ॾियारणु	ڏيارَڻُ
ॾियारणु	ڏيارڻ
ॾियारींदड़	ڏياريندڙ
ॾियारींदड़्	ڏياريندڙ
ॾिसण	ڏسڻ
ॾिसण	ڏِسَڻَ
ॾिसणु	ڏسڻ
ॾिसिजणु	ڏسجڻ
ॾिसी	ڏسي
ॾिसंदड़	ڏسندڙ
ॾिंगाई	ڏنگائي
ॾिंगो	ڏنگو
ॾीओ	ڏيئو
ॾीन्दड़ु	ڏيندڙ
ॾीये	ڏئي
ॾीलु	ڏيل
ॾींदड़	ڏيندڙ
ॾींदड़ि	ڏيندڙ
ॾींदड़ु	ڏيندڙ
ॾींदड़ु	ڏيِندَڙ
ॾींदड़्	ڏيندڙ
ॾींदड़्	ڏيندڙُ
ॾींदड़्	ڏيِندَڙ
ॾींदे	ڏيِندي
ॾींहुं	ڏينھن
ॾींहं	ڏينھن
ॾींहं	ڏيِنهَن
ॾुकार्	ڏڪار
ॾुख	دُکَ
ॾुख	ڏک
ॾुखाइणु	ڏکائڻ
ॾुखाइतो	ڏکائتو
ॾुखियो	ڏکيو
ॾुखियो	ڏُکِيو
ॾुखु	ڏک
ॾुखु	ڏُکُ
ॾुखोईंदड़	ڏکوئيندڙ
ॾुखोयल	ڏکويل
ॾुख्याई	ڏکيائي
ॾुख्यो	ڏکيو
ॾुख्यो	ڏُکِيو
ॾुॾु	ڏُڏُ
ॾुधु	ڏُڌُ
ॾुधु	ڏڌ
ॾुॿराई	ڏٻرائي
ॾुॿरो	ڏٻرو
ॾुहणु	ڏُهَڻُ
ॾुहाई	ڏهائي
ॾुहाॻिणि	ڏهاڳڻ
ॾूरांहों	ڏورانهون
ॾे	ڏي
ॾे-ई	ڏيئي
ॾेख	ڏيک
ॾेखरणु	ڏيکارڻ
ॾेखाइतो	ڏيکائتو
ॾेखाउ	ڏيکاءُ
ॾेखारणु	ڏيکارَڻُ
ॾेखारणु	ڏيکارڻ
ॾेखारणु	ڏيکارڻُ
ॾेखारिणु	ڏيکارڻ
ॾेखारी	ڏيکاري
ॾेखारींदड़	ڏيکاريندڙ
ॾेखाव	ڏيکاو
ॾेखु	ڏيک
ॾेख्	ڏيک
ॾेख्दार	ڏيکدار
ॾेॾर	ڏيڏر
ॾेॾरु	ڏيڏر
ॾेती	ڏيتي
ॾेरो	ڏيرو
ॾेवालो	ڏيوالو
ॾेव्रो	ڏيورو
ॾेही	ڏيھي
ॾेंभू	ڏينڀو
ॾोई	ڏوئي
ॾोखी	ڏوکي
ॾोॾो	ڏوڏو
ॾोरापे	ڏوراپي
ॾोरापो	ڏوراپو
ॾोरि	ڏور
ॾोरि	ڏوري
ॾोरी	ڏوري
ॾोलु	ڏول
ॾोह	ڏوھ
ॾोह	ڏوه
ॾोहारी	ڏوھاري
ॾोही	ڏوهي
ॾोही	ڏوھي
ॾोहीअड़ो	ڏوھيئڙو
ॾोहीड़ो	ڏوهيڙو
ॾोहु	ڏوھ
ॾोहु	ڏوه
ॾोहु	ڏوهُ
ॾोह्टी	ڏوھٽي
ॾोह्टो	ڏوھٽو
ॾंगणु	ڏنگڻ
ॾंडु	ڏنڊ
ॾंडो	ڏنڊو
ॾंड्वत	ڊنڊوت
ॾंद	ڏند
ॾंदन	ڏندن
ॾंदु	ڏنڌ
ॾंदु	ڏند
ढओंघ	ڍونگھ
ढक	ڍڪ
ढकणु	ڍَڪَڻُ
ढकणु	ڍڪڻ
ढकणु	ڍڪيل
ढकियल	ڊڪيل
ढकु	ڍڪ
ढके	ڍڪي
ढॻा	ڍڳا
ढॻो	ڍَڳو
ढॻो	ڍڳو
ढन्गु	ڍنگ
ढल	ڍل
ढव	ڊو
ढापण	ڍاپڻ
ढार	ڍار
ढाल	ڊال
ढाहिणु	ڍاهڻ
ढांचो	ڍانچو
ढिॻु	ڍڳ
ढिर	ڍر
ढिराइतो	ڍرائتو
ढिराई	ڍرائي
ढिरो	ڍرو
ढिलाई	ڍلائي
ढिलो	ڍلو
ढुकु	ڍُڪ
ढुकु	ڍڪ
ढेर	ڍير
ढेरु	ڍير
ढेर्	ڍير
ढोअणु	ڍؤڻ
ढोइणु	ڊوهڻ
ढोड़	ڍور
ढोन्ग	ڊونگ
ढोलिणो	ڊولڻو
ढोंग	ڍونگ
ढोंगी	ڍونگي
ढोंगु	ڍونگ
ढंग	ڍنگ
ढंगाइतो	ڍنگائتو
ढंगु	ڍنگ
ढंढ	ڍنڍ
ढ्^यान	ڌيان
त	ت
त	تَ
त	تہ
तक	تَڪَ
तकड़	تَڪَڙ
तकड़	تڪڙ
तकड़ि	تڪڙ
तकड़्	تڪڙ
तकणु	تڪڻ
तकाज़ा	تقاضا
तकिड़ो	تڪڙو
तकु	تڪ
तक्ड़ो	تڪڙو
तक्दीर	تقدير
तक्दीर्	تقدير
तक्नीकी	تڪنين
तक्रार	تڪرار
तक्रार	تقرار
तक्रारी	تڪراري
तक्रारु	تڪرار
तक्रार्	تڪرار
तक्रार्	تقرار
तक्रीर	تقرير
तक्रीर्	تقرير
तक्लीफ़	تڪليف
तक्लीफ़	تَڪِليِفَ
तक्लीफ़्	تڪليف
तक्लीफ़्वारो	تڪليفوارو
तक्सीम	تقسيم
तख़्त	تخت
तख़्त	تَختَ
तख़्ती	تختي
तख़्तीअ	تخطيع
तख़्तु	تخت
तख़्तो	تختو
तजणु	تجڻ
तजिर्बो	تجربو
तजिलो	تجلو
तज्रिबो	تَجِرِبو
तज्लो	تجلو
तज्वीज़	تجويز
तज्वीज़्	تجويز
तड़	تڙ
तड़ो	تڙو
तड़्क	تڙڪ
तड़्फणु	تڙڦڻ
तॾहिं	تڏهن
तॾहोको	تڌهوڪو
तॾो	تڏو
ततु	تت
ततु	تتُ
ततु	تَتُ
तत्काल	تتڪال
तत्मो	تتمو
तदारक	تدارڪ
तनावु	تناو
तन्ज़	طنز
तन्ज़ी	طنزي
तन्दुरुस्त	تندرست
तन्दुरुस्ती	تندرستيِ
तन्दुरुस्त्	تندرست
तन्हाई	تنهائي
तप	تپ
तपति	تپت
तपत्	تپت
तपस्वी	تَپَسويِ
तपास	تپاس
तपासणु	تپاسڻ
तपासींदड़्	تپاسيندڙ
तपास्	تپاس
तपियल्	تپيل
तपु	تپ
तप्णो	تپڻو
तप्यल्	تپيل
तफ़ावत	تفاوت
तफ़ावत	طفاوت
तफ़ावतु	تفاوت
तफ़ावतु	طفاوت
तफ़ावत्	طفاوت
तफ़्सील	تفصيل
तफ़्सील्	تفصيل
तफ़्सील्वार	تفصيلوار
तबादिलो	تبادلو
तबाही	تباهي
तबाही	تباھي
तबीब	طبيب
तबीबु	طبيب
तबीब्	طبيب
तबेलो	تبيلو
तब्को	طبقو
तब्दील	تبديل
तमाक	تَماڪ
तमाम	تمام
तमाम	تَمام
तमाम	طمام
तमाम्	تمام
तमाशो	تماشو
तमीज़	تميز
तमंचो	تمنچو
तर	تر
तर	تَر
तरकी	ترقي
तरणु	ترڻ
तरणु	تَرَڻُ
तरफ़	طرف
तरफ़	طَرَف
तरफ़ु	طرف
तरफ़्दार	طرفدار
तरफ़्दारी	طرفداري
तरफ़्दार्	طرفدار
तरल	ترل
तरस	ترس
तरसु	تَرَسُ
तरह	طرح
तरह	طَرَح
तरह	طره
तरह्	طرح
तरह्	طَرَح
तराई	ترائي
तराख्ड़ो	تراکڙو
तरानो	ترانو
तरार	ترار
तरावती	تراوتي
तराशणु	تراشڻ
तरि	تر
तरीको	طريقو
तरु	تر
तरु	تل
तरे	تري
तरो	ترو
तरंग	ترنگ
तरंदड़	ترندڙ
तरंदड़ु	ترندڙ
तरंदड़्	ترندڙ
तर्क	ترڪ
तर्की	ترقي
तर्कीब	ترڪيب
तर्कु	ترڪ
तर्ज़	ترز
तर्जीह	ترجيح
तर्जीही	ترجيحي
तर्जुमान	ترجمان
तर्जुमो	ترجمو
तर्ज्मो	ترجمو
तर्तीब	ترتيب
तर्तीब्	ترتيب
तर्दीद	ترديد
तर्फ़ो	طرفو
तर्फ़्दार	طرفدار
तर्बतर	تربتر
तर्यलु	تريل
तर्सणु	ترسڻ
तर्साइणु	ترسائڻ
तलाउ	تلاءُ
तलाक	طلاق
तलाश	تلاش
तलाशी	تلاشي
तलाशीअ	تلاشيءَ
तलाश्	تلاش
तल्ब	طلب
तल्वार	تلوار
तवानो	توانو
तवारीख़ी	تواريخي
तवील	تويل
तव्हां	توهان
तव्हीं	توهين
तश्ख़ीस	تَشِخيصَ
तश्रीही	تشريحي
तसली	تسلي
तस्दीक	تصديق
तस्री	تسري
तस्वीर	تصوير
तस्वीर	صوير
तस्वीरुन	تصويرون
तस्वीर्	تصوير
तहख़ानो	تهخانو
तहिख़ानो	تھخانو
तहिं	تنهن
तहिंकरे	تنھنڪري
तहु	تح
तहु	ته
तह्कीकात	تحقيقات
तह्ज़ीब	تھذيب
तह्ज़ीब	تهذيب
तह्ज़ीब्	تھذيب
तह्रीक	تهريڪ
तह्सील	تحسيل
ताईं	تائين
ताक	تاڪ
ताकत	تاقت
ताकत	طاقت
ताकत्	طاقت
ताकी	طاقي
ताकीद	تاقيد
ताकीद	تاقيدَ
ताकीद	تاڪيد
ताकीदी	تاڪيدي
ताकीदो	تاقيدو
ताकु	تاڪ
ताज	تاج
ताजुब्	تعجب
ताज़ो	تازو
ताज़्गी	تازگي
ताज़्गीअ	تازگي
ताड़े	تاڙي
ताड़्यूं	تاڙيون
ताणणु	تاڻڻ
ताण्यलु	تانڻيل
ताण्यलु	تاڻيل
तात्पर्ज	تاتپرج
तात्पर्ज़ु	تات
तात्पुर्ज	واوپرج
तादी	تاديِ
तादी	تعدي
तानाज़न	طعنازن
तानाशाही	تاناشاهي
तानाशाहु	تاناشاه
तानो	تعنو
तानो	طعنو
ताबेदार	تعبيدار
ताबेदारी	تعبيداري
ताबेदार्	تابعدار
तामील	تعميل
तामु	تام
तार	تار
ताराज़ी	تارازي
तारीख़	۾
तारीख़	تاريخ
तारीफ़	تعاريف
तारीफ़	تعريف
तारूं	تارون
तारो	تارو
तालिब्	طالب
तालीम	تعليم
तालीमी	تعليمي
तालु	تال
तालुक	تعلق
तालुको	تعلقو
तालुक्	تعلق
तालुक्	تعلُق
तालेम	تعليم
तालो	تالو
ताल्मेलु	تالميل
ताल्मेल्	تالميل
तावणु	تاوڻ
तावीज़	تعويذ
तावीज़ु	تعويذ
तास	تاس
तासबु	تعصب
तां	تان
तांघो	تانگھو
तिखाई	تکائي
तिखी	تکي
तिखे	تِکي
तिखो	تکو
तिॻाइणु	تڳائڻ
तिजिलेदार	تجليدار
तिजोड़ी	تجوڙي
तिज्लेदार	تجليدار
तिज्लो	تجلو
तियाॻु	تياڳ
तियार	تيار
तियारी	تياري
तिर	تر
तिरी	تري
तिरु	تر
तिर्कणु	ترڪڻ
तिर्किणो	ترڪڻو
तिर्छो	ترڇو
तिर्विरा	ترورا
तिर्विरा	تِرِوِرا
तिर्विरो	ترورو
तीअं	تيئن
तीर	تير
तीरन	تيرن
तीर्	تير
तीर्थ	تيرٿ
तीर्थु	تيرٿ
तीली	تيلي
तीसर	تيسر
तीसो	تيسو
तुक्बंदी	تڪبندي
तुछ	تڇ
तुछु	تُڇُ
तुछु	تڇ
तुछ्	تڇ
तुज़	تُزُ
तुड़ी	تڙي
तुम्बो	تمبو
तुरणु	ترڻ
तुरही	ترهي
तुरही	ترھي
तुर्त	ترت
तुर्तु	ترت
तुर्त्	ترت
तुल्ना	تلنا
तुहिमत	تھمت
तुहिंजा	تنهنجا
तुहिंजी	تنهنجي
तुहिंजो	تنهنجو
तुह्मत	تھمت
तुह्मत्	تھمت
तुंहिंजो	تنهنجو
तूत	توت
तूतारो	توتارو
तूफ़ान	طوفان
तूफ़ानी	طوفاني
तूफ़ानु	طوفان
तूफ़ान्	طوفان
तूल	تول
तूं	تون
ते	تي
ते	وي
तेज़	تيز
तेज़	ڪرڻ
तेज़ाबी	تيزابي
तेज़ी	تيزي
तेज़ी	تيزيِ
तेज़ी	وِيرَ
तेजु	تيج
तेज़्	تيز
तेज्स्वी	تيجسوي
तेरहां	تيرهن
तेल	تيل
तेलु	تيل
तेसीं	تيسين
तै	تيَ
तैलीम	تعليم
तैसबी	تعصبي
तैसब्	تعصب
तोखे	توکي
तोड़े	توڙي
तोड़्	توڙ
तोते	طوطي
तोतो	طوطو
तोब	توبَ
तोर	تور
तोर	تورَ
तोर	تورا
तोर	طور
तोरणु	تورڻ
तोरि	طور
तोशक	توشڪ
तोशा	توشا
तोहीन्	توھين
तोंद	توند
तौंरी	تَونري
तंकीद	تنقيد
तंख़्वाह	تنخواه
तंग	تنگ
तंग	تِنگِ
तंगि	تنگ
तंगी	تنگي
तंग्दिल	تنگدل
तंग्दिल्	تنگدل
तंज़	تنز
तंजणु	تنجڻ
तंत	تَنتَ
तंतु	تَنتُ
तंदु	تند
तंदुन	تندن
तंदुरुस्त	تندرست
तंदुरुस्ती	تندرستي
तंदुरुस्तु	تندرست
तंदुरुस्त्	تندرست
तंदुर्स्ती	تندرستي
तंदुर्स्तीअ	تندرستيءَ
तंदूरो	تندورو
तंबू	تنبو
तंवारणु	تنوارڻ
तंहिं	تنھن
तंहिं	تنهن
त्याॻ	تياڳ
त्याॻ	تِياڳ
त्याॻण	تياڳڻ
त्याॻणु	تياڳڻ
त्याॻु	تياڳ
त्याॻु	تِياڳُ
त्यार	تيار
त्यार	تياري
त्यारी	تياري
त्यारी	تياريِ
त्रिकोणु	ترڪوڻ
त्रिक्ताल	ترڪتال
त्रिपदु	ترپد
त्रिप्ती	ترپتي
त्रिश्न	ترشنا
त्वारीख़ी	تواريخي
त्वारीख़ी	تواريخيِ
थक	ٿڪ
थकल	ٿَڪَلُ
थकल	ٿڪل
थकलु	ٿڪل
थकल्	ٿڪل
थकाइणु	ٿڪائڻ
थकाईंदड़	ٿڪائيندڙ
थकाईंदड़	ٺهڪائيندڙ
थकाईंदड़्	ٿڪائيندڙ
थकु	ٿڪ
थको	ٿڪو
थक्जंदड़	ٿڪٿندڙ
थड़ो	ٿڙو
थणु	ٿڻ
थदे	ٿدي
थधाईअ	ٿڌائيءَ
थधाण्	ٿڌاڻ
थधि	ٿڌ
थधिड़ा	ٿڌڙا
थधे	ٿڌي
थधो	ٿدو
थधो	ٿڌو
थन्भो	ٿنڀو
थपी	ٿپي
थप्की	ٺپَڪيِ
थप्की	ٿپڪي
थप्की	ٺَپڪيِ
थफड़	ٿڦڙ
थफड़	ٿپڙ
थम्बो	ٿنبو
थर्थराहट	ٿرٿراهٽ
थर्थिलो	ٿرٿلو
थल	ٿل
थल्हो	ٿلهو
थही	ٿهي
थहो	ٿهو
थाणो	ٿاڻو
थादलि	ٿادل
थानु	ٿان
थापणु	ٿاپڻ
थाफियल	ٿاڦيل
थाफोड़ा	ٿاڦوڙ
थाॿा	ٿاٻا
थाॿिर्जण	ٿاٻرجڻ
थाॿो	ٿاٻو
थाल्ही	ٿالهي
थाल्ही	ٿالھي
थांईको	ٿانيئڪو
थांउ	ٿانءُ
थांको	ٿانڪو
थांव	ٿانو
थिए	ٿئي
थिॻरी	ٿڳڙي
थिॻिड़ी	ٿڳڙي
थिड़्कणु	ٿرڪڻ
थियण	ٿيڻ
थियणी	ٿيڻي
थियणु	ٿِيَڻُ
थियणु	ٿيڻ
थियणु	ٿيڻُ
थियणुव्	ٿيڻ
थियणो	ٿيڻو
थियल	ٿيل
थियलु	ٿيل
थियल्	ٿيَل
थियासाफ़ी	ٿياسافي
थी	ٿي
थी	ٿيِ
थींदड़	ٿيندڙ
थींदड़्	ٿيندڙ
थींदड़्	ٿيندڙُ
थींदर	ٿيندڙ
थुक	ٿڪ
थुकु	ٿڪ
थुड़ु	ٿڙ
थुॾणु	ٿڏڻ
थुल्ही	ٿلهي
थुल्हे	ٿلهي
थुल्हेरो	ٿلهيرو
थुल्हो	ثُلهو
थुल्हो	ٿلهو
थुल्हो	ٿلھو
थूणी	ٿوڻي
थूम	ٿوُمَ
थेटरु	ٿئيٽر
थेलो	ٿيلو
थेल्ही	ٿيلهي
थेल्ही	ٿيلھي
थेल्हो	ٿيلھو
थो	ٿو
थोकि	ٿوڪ
थोड़ो	ٿورو
थोड़ो	ٿوڙو
थोथिर्जणु	ٿوٿرجڻ
थोर	ٿور
थोरा	ٿورا
थोराई	ٿورائي
थोरिड़ो	ٿورڙو
थोरे	ٿوري
थोरेड़ो	ثوريڙو
थोरो	ٿورو
थोरो	ٿوڙو
थोर्ड़ो	ٿورڙو
थोल्ह	ٿوله
थंबो	ٿنبو
थंभो	ٿنڀو
थ्काइणु	ٿڪائڻ
थ्काईंदड़	ٿڪائيندڙ
थ्धो	ٿڌو
थ्यण	ٿِيَڻَ
थ्यण	ٿيڻ
थ्यणी	ٿيڻي
थ्यणु	ٿيڻ
थ्यणो	ٿيڻو
थ्यल	ٿيل
थ्यलु	ٿيل
द	دِل
दक	دڪ
दक्	دڪ
दख़ल	دخل
दख़ल	دَخَل
दख़लु	دخل
दख़ुल	داخُل
दख़्ली	دخلي
दग़ा	دغا
दग़ाबाज़	دغاباز
दग़ाबाज़ी	دغابازي
दग़ाबाज़्	دغاباز
दॻु	دڳ
दड़्को	دڙڪو
दड़्को	ڌڙڪو
दध्को	دھڪو
दफ़न	دفن
दफ़न	ڪَرَڻُ
दफ़न्	دفن
दफ़ा	دفعا
दफ़ु	دف
दफ़्तर	دفتر
दॿ	دٻ
दॿलो	دٻلو
दॿाइणु	دٻآئڻ
दॿाइणु	دٻائڻ
दॿाईंदड़	دٻائيندڙ
दॿाउ	دٻاء
दॿाए	دٻائي
दॿाव	دٻاو
दॿावु	دٻاو
दॿो	دَٻو
दॿो	دٻو
दम	دم
दम	دَم
दमु	دم
दया	ديا
दयालू	ديالو
दयावान	دياوان
दर	پچ
दरख़तु	ڌرخت
दरसल	دراصل
दराज़ु	دراز
दरार	درار
दरार्	درار
दरी	دري
दर्खुवास्त्	درخواست
दर्ख़्वास्त	درخواست
दर्गाह	درگاه
दर्ज	درج
दर्जनु	درجن
दर्ज़िणि	درزڻ
दर्ज़ी	درزي
दर्जे	درجي
दर्जो	درجو
दर्द	درد
दर्द्	درد
दर्बान	دربان
दर्बान्	دربان
दर्म्यानी	درمياني
दर्याई	دريائي
दर्याही	درياهي
दर्याही	درياھي
दर्याहु	درياه
दर्वाज़ो	دروازو
दर्वेश	درويش
दर्शक	درشڪ
दर्शन	درشن
दर्शनु	درشن
दर्शन्	درشن
दर्सनी	درسني
दलाली	دلالي
दलाल्	دلال
दलील	دليل
दलीलन	دليلن
दलु	دل
दल्दल	دلدل
दवा	دوا
दवाउन	دوائن
दवाख़ानो	دواخانو
दवासाज़ी	دواسازي
दस्त	دست
दस्तख़त	دستخط
दस्ता	دستا
दस्तानो	دستانو
दस्तावीज़्	دستاويز
दस्तावेज़	دستاويز
दस्ती	دستي
दस्तूर	دستور
दस्तूरी	دستوري
दस्तूरु	دستور
दस्तो	دستو
दस्त्कारी	دستڪاري
दही	دَهيِ
दह्लाइणु	دهلائڻ
दह्लाईंदड़	دهلائيندڙ
दह्शत	دهشت
दह्शत्	دھشت
दह्शत्गर्द	دهشتگرد
दाइम	دائم
दाइमी	دائمي
दाइमी	دائِميِ
दाइमी	داٰئِمي
दाइम्	دائم
दाइरो	دائرو
दाई	دائي
दाउ	دا۽
दाउ	داء
दाउ	داءُ
दाख़िल	داخل
दाख़िल	داصل
दाख़िल्	داخل
दाख़ुल	داخُل
दाख़ुल	داخُلُ
दाख़ुला	داخُلا
दाख़्ला	داخلا
दाख़्ला	داخِلا
दाख़्लात्	داخلات
दाग़ु	داغ
दाग़्	داغ
दाग़्^उ	داغ
दाॻ	داڳ
दाॻु	داڳ
दाण	داڻ
दाणो	داڻو
दाता	داتا
दाद्लो	دادلو
दान	دان
दानाउ	داناءُ
दानी	داني
दानी	دانيِ
दान्	دان
दान्वीर	دانوير
दार	دار
दारूं	دارون
दारोग़ो	داروغو
दाल	دال
दालि	دال
दावत	دعاوت
दावत	دعوَت
दावा	داوا
दावा	دعوا
दावा	دعوي
दावेदार	دعويدار
दावेदार्	دعويدار
दास	داس
दासु	داس
दांह	دانه
दांहं	دانهن
दिक्शा	دڪشا
दिमाग़	دماغ
दिमाग़ी	دِماغيِ
दिमाग़ु	دِماغ
दिल	دل
दिल	دِل
दिल	دِلِ
दिल	ڀرائي
दिलासो	دلاسو
दिलि	دل
दिली	دلي
दिलेर	دلير
दिलेरी	دليري
दिल्	دل
दिल्कश्	دلڪش
दिल्गीर	دلگير
दिल्गीर	دِلگيِر
दिल्चस्प	دلچسپ
दिल्चस्पी	دلچسپي
दिल्दार	دلدار
दिल्बर	دِلِبَر
दिल्मनु	دلمن
दिल्सोज़	دلسوز
दिव्य	دِوِيَ
दीदी	ديدي
दीदो	ديدو
दीबाचो	ديباچو
दीवानो	ديوانو
दीवारि	ديوار
दीवांगी	ديونگي
दुआ	دعا
दुआ	دُعا
दुकान	دڪان
दुकानु	دڪان
दुकान्दार	دڪاندار
दुख	دک
दुख	ڏک
दुखदाई	دکدائي
दुखाइणु	دکائڻ
दुखी	دکي
दुखु	دک
दुख्दाइक	دکدائڪ
दुख्दाई	دکدائي
दुन	دن
दुनिया	دنيا
दुन्यवी	دنيوي
दुन्या	دُنيا
दुम्ब्रो	دمبرو
दुरिस्त	درست
दुरी	دري
दुरुस्त	درست
दुरुस्ती	درستي
दुरुस्तु	درست
दुर्गती	درگتي
दुर्गम	درگم
दुर्घटना	درگھٽنا
दुर्घट्ना	درگھٽنا
दुर्दशा	دردشا
दुर्ॿल	دربل
दुर्ॿल्ता	درٻلتا
दुर्ॿोध	درٻوڌ
दुर्भाव	درڀاو
दुर्भाव्ना	درڀاونا
दुर्लभ	درلڀ
दुर्स्त	درست
दुर्स्त	دُرست
दुर्स्ती	درستي
दुश्ट	بدمعاش
दुश्ट	دشٽ
दुश्टता	دشٽتا
दुश्टु	دشٽ
दुश्ट्ता	دشٽتا
दुश्मन	دشمن
दुश्मन	دُشمَن
दुश्मनी	دشمني
दुश्मन्	دشمن
दुहिराइणु	دهرائڻ
दुहिलु	دھل
दुह्राउ	دهراءُ
दुह्रो	دھرو
दुह्लारी	دھلاري
दुंबो	دنبو
दूत	دوت
दूर	دور
दूरांदेश	دوُرانديش
दूरांदेश	دورنديش
दूरांदेशी	دورانديشي
दूरांदेशी	دوُرانديشي
दूरांदेशीअ	دورانديشيءَ
दूरांदेश्	دوُراَنديش
दूरी	دوري
दूरीअ	دوُريِءَ
दूरंदेश	دورانديش
दूर्	دور
दूर्	دوُر
दूर्दर्शकु	دوردرشڪ
दूर्दस्ती	دوردستي
दूर्बीन	دوربين
दूर्बीनी	دوربيني
दूस	دوس
दूसणु	دوسڻ
दूसे	دوسي
दूंहों	دونهون
दूंहों	دوُنھو
देॻड़ो	ديڳڙو
देर	دير
देरि	دير
देरो	ديرو
देव	ديو
देवल	ديول
देवी	ديوي
देव्ता	ديوتا
देव्ताई	ديوتائي
देश	ديش
देशद्रोहु	ديشدروه
देशु	ديش
देश्द्रोही	ديشدروه
देस	ديس
देस	ديسَ
देसी	ديسي
देस्	ديس
देह	ديه
देहाती	ديهاتي
दोखे	دوکي
दोखेबाज़	دوکيباز
दोखो	دوکو
दोज़क्ख़ी	دوزخي
दोज़ख़ी	دوزخي
दोज़ख़्	دوزخ
दोश	دوش
दोशु	دوش
दोस्ताणो	دوستاڻو
दोस्ती	دوستي
दोस्तु	دوست
दोस्त्	دوست
दोस्त्पिणो	دوستپِڻو
दोहिराइणु	دوهرائڻ
दोहो	دوھو
दोह्राइणु	دوهرائڻ
दौर	دَور
दौरु	دَور
दौरो	دور
दौलत	دولت
दौलत्मंद	دولتمند
दंगाई	دنگائي
दंगो	دنگو
द्ॿाइणु	دٻائڻ
द्यणु	ڏيڻ
द्रिश्टांट्	درشٽانت
द्रिश्टी	درشٽي
द्रिश्टीकोणु	درشٽيڪوڻ
द्रिहड़्ता	درهڙتا
द्वारां	دوارا
द्वारां	دواران
द्वार्पाल्	دوارپال
धक	ڌڪ
धकाउ	ڌڪاء
धकाउ	ڌڪاءٌ
धकाउन्	ڌڪاء
धकु	ڌڪ
धॻो	ڌاڳو
धड़क	ڌڙڪ
धड़ु	ڌڙ
धड़्कणि	ڌڙڪڻ
धड़्कणु	ڌڙڪڻ
धड़्कण्	ڌڙڪڻ
धणी	ڌڻي
धणीअ	ڌڻيءَ
धणु	ڌڻ
धधिको	ڌَڌِڪو
धध्को	ڌڌڪو
धनारु	ڌنار
धनी	ڌني
धनु	ڌن
धन्यवाद	ڌنيواد
धन्य्वाद	ڌنيواد
धन्वान	ڌنوان
धप	ڌپ
धमाकेदार	ڌماڪيدار
धमाको	ڌماڪو
धमाको	ڌَماڪو
धम्काइणु	ڌمڪائڻ
धम्काइणु	ڌَمِڪائِڻُ
धम्काईंदड़	ڌمڪائيندڙ
धम्की	ڌمڪي
धम्कीअ	ڌمڪيءَ
धरम	ڌرم
धरमु	ڌرم
धरम्शाला	ڌرمشالا
धरम्हीणु	ڌرمهين
धरावत	ڌراوت
धरावत्	ڌراوت
धर्घ्यल	ڌرگھيل
धर्णो	ڌرڻو
धर्ती	ڌرتي
धर्ती	ڌَرتي
धर्ती	ڌَرتيِ
धर्तीअ	ڌرتيءَ
धर्म	ڌرم
धर्मता	ڌرمتا
धर्माऊ	ڌَرمائوُ
धर्मात्मा	ڌرماتما
धर्मी	ڌرمي
धर्म्क्रिया	ڌرمڪريا
धस्जणु	ڌسجڻ
धाइणु	ڌائڻ
धाको	ڌاڪو
धाॻो	ڌاڳو
धाड़ेल	ڌاڙيل
धाड़ो	ڌاڙو
धातू	ڌاتو
धातू	ڌاتوُ
धातूअ	ڌاتوءَ
धातूअ	ڌاتوُءُ
धार	ڌار
धार	ڌارا
धार	تيز
धारण	ڌارڻ
धारणु	ڌارڻ
धाराइणु	ڌارائڻ
धार्मिक	ڌارمڪ
धार्मिक्ता	ڌارمڪتا
धार्यो	ڌاريو
धिकणु	ڌڪڻ
धिकार	ڌڪار
धिकारणु	ڌڪارڻ
धिकारिणु	ڌڪارڻ
धिकारी	ڌڪاري
धिकारु	ڌڪار
धिकार्	ڌڪار
धिको	ڌڪو
धियन	ڏيڻ
धीउ	ڌيء
धीरज	ڌيرج
धीरजु	ڌيرج
धीरज्वान	ڌيرجوان
धीरे	ڌيري
धीर्ज	ڌيرج
धुअणु	ڌئڻ
धुको	ڌُڪو
धुॾणु	ڌُڏَڻُ
धुॾणु	ڌڏڻ
धुॾंदड़	ڌڏندڙ
धुत	ڌت
धुतार	ڌتار
धुतारणु	ڌتارڻ
धुतारींदड़	ڌتاريندڙ
धुति	ڌت
धुतिर	ڌتر
धुन्धु	ڌنڌ
धुॿण	ڌٻڻ
धुॿणु	ڌُٻَڻُ
धुॿण्	ڌٻڻ
धुरि	ڌر
धुंधिल्को	ڌنڌلڪو
धुंधु	ڌنڌ
धुंधु	ڌُنڌُ
धुंध्	ڌُنڏُ
धुंध्लो	ڌنڌلو
धुंध्लो	ڌُنڌلو
धूक	ڌوڪ
धूकींदो	ڌوڪيندو
धूड़	ڌوڙ
धूड़्यो	ڌوڙيو
धूणणु	ڌوڻڻ
धूम्धाम	ڌومڌام
धोअणु	ڌوئڻ
धोक्ड़ी	ڌوڪڙي
धोॾो	ڌوڏو
धोॿिणि	ڌوٻڻ
धोॿी	ڌوٻيِ
धंधेवारो	ڌنڌيوارو
धंधो	ڌندو
धंधो	ڌندڌو
धंधो	ڌنڌو
ध्तारणु	ڌتارڻ
ध्याणी	ڌياڻي
ध्यान	ڌيان
ध्यान	ڌِيان
ध्यानु	ڌيان
ध्यान्	ڌيان
ध्रू	ڌرو
न	ن
न	نَ
न	نہ
न	نا
नईं	نئين
नए	نئين
नएं	نئين
नओं	نئون
नओं	نَٰئون
नक	نڪ
नकल	نقل
नकलु	نقل
नकल्	نقل
नकाब	نقاب
नकाबु	نڪاب
नकाबु	نقاب
नकाब्	نقاب
नकाम्याब	ناڪامياب
नकाश	نقاش
नकाशी	نقاشي
नकु	نڪ
नकुलु	نقل
नक्ली	نقلي
नक्शो	نقشو
नक्श्	نقش
नक्श्बंदी	نَقِشِبَنديِ
नख़िरो	نخرو
नख़्रो	نازنخرو
नख़्रो	نخرو
नगर	نگر
नगरु	نگر
नचणु	نچڻ
नचंदो	نچندو
नज़र	نَضَرَ
नज़र	نطر
नज़र	نظر
नज़र	نَظَرَ
नज़रियो	نظريو
नज़रंदाज़	نظرناداز
नज़र्	نَضَر
नज़र्	نظر
नज़र्दारी	نظرداري
नज़र्बंद	نظربند
नज़र्बंदी	نظربندي
नज़र्सानी	نظرساني
नज़ाकत	نزاڪت
नज़ाकत	نزاقت
नज़ारो	نظارو
नजूमी	نجومي
नजूम्	نجوم
नज़्दीक	نزديڪ
नज़्दीकी	نزديڪي
नज़्दीक्	نذديڪ
नज़्रानो	نذرانو
नज़्रानो	نظرانو
नटाइणु	نٽائِڻُ
नटाइणु	نٽائڻ
नटाऊ	نٽائوُ
नट्खट्	نٽکٽ
नड़ो	نڙو
नतीजे	نتيجي
नतीजो	نتيجو
नतीजो	نتِيجو
नदी	ندي
नदीअ	نديءِ
नन्ढो	ننڍو
नपूंसक	نپونسڪ
नफ़स्परस्त	نفسپرست
नफ़स्परस्ती	نفسپرستي
नफ़ासत	نفاست
नफ़ो	نفعو
नफ़्रत	نفرت
नफ़्रत्	نفرت
नफ़्री	نفري
नफ़्सानी	نفساني
नबाल्ग़ी	نابالغي
नबी	نبي
नब्ज़	نبض
नम	نم
नमक	نمڪ
नमस्कार	نمسڪار
नमी	نمي
नमूनन	نمونن
नमूने	نموني
नमूने	نَمُوني
नमूने	نَموُني
नमूनो	نمونو
नमूनो	نَموُنو
नम्कीन	نمڪين
नम्बर	نمبر
नम्रता	نمرتا
नर	نر
नरम	نرم
नरमु	نرم
नरम्दिली	نرمدلي
नरु	نر
नर्की	نرڪي
नर्ॻ	نرڳ
नर्ॻु	نرڳ
नर्माइणु	نرمائڻ
नर्माई	نرمائي
नर्माईअ	نرمائيءَ
नर्मी	نرمي
नर्मीअ	نرميءَ
नर्सि	نرس
नर्हत्या	نرھتيا
नली	نلي
नलु	نل
नल्को	نلڪو
नवम्बर	نومبر
नवाज़	نواز
नवाज़ी	نوازي
नवाज़ीअ	نوازيءَ
नवाज़्	نواز
नवाण	نواڻ
नवाब	نواب
नवीसी	نويسي
नवीस्	نويس
नवीस्	نَويِس
नवेक्लो	نويڪلو
नवं	نو
नव्जीवन	نوجيون
नशई	نشئي
नशीन	نشين
नशीनी	نشيني
नशीली	نشيلي
नशीलो	نشيلو
नशे	نشي
नशेदार	نشيدار
नशेबु	نشيب
नशेली	نشيلي
नशो	نشو
नश्वर	نشور
नश्वर्ता	نشورتا
नस	نس
नसीब	نصيب
नसीबा	نصيبا
नसीबां	نصيبان
नसीबी	نصيبي
नसीबु	نصيب
नसीब्	نصيب
नसीम	نسيم
नसीहत	نصيحت
नसीहत्	نصيحت
नसुल	نسل
नसुली	نصلي
नसुल्	نسل
नस्लु	نسل
नस्सेब	نصيب
ना	نا
नाइब	نائب
नाउमीदी	نااميدي
नाउमीदीअ	نااميديء
नाकाबिल्	ناقابل
नाकाबंदी	ناڪابندي
नाकाबंदी	ناقابندي
नाकाम	ناڪام
नाकाम्ब्याब	ناڪامياب
नाकाम्याब	ناڪامياب
नाकाम्याब	ناقامياب
नाकाम्याबी	ناڪاميابي
नाकार	ناڪار
नाकारी	ناڪاري
नाकार्	ناڪار
नाक्	ناڪ
नाख़लफ़	ناخلف
नाख़ुश	ناخوش
नाचाक	ناچاڪ
नाचाक	ناچاق
नाचु	ناچ
नाज़	ناز
नाज़रूरी	ناضروري
नाजाइज़ी	ناجائزي
नाज़िक	نازڪ
नाज़िक्	نازڪ
नाज़ु	بازي
नाज़ुक	نازڪ
नाज़ुक्	نازڪ
नाज़ुक्दिल	نازڪدل
नाटक	ناٽڪ
नाटकी	ناٽڪي
नाटकु	ناٽڪ
नाटक्शाला	ناٽڪشالا
नाट्काणो	ناٽڪاڻو
नाट्की	ناٽڪي
नाठी	ناٺي
नाड़	ناڙ
नाड़ो	ناڙو
नाणो	ناڻو
नाताल	ناتال
नाताली	ناتاليِ
नातो	ناتو
नातो	ناطو
नात्यार	ناتيار
नादुरुस्ती	نادرستي
नाना	نانا
नानी	ناني
नान्वाई	نانوائي
नापसंद	ناپساند
नापसंद	ناپسند
नापाक	ناپاڪ
नापाकी	ناپاڪي
नाबराबर	نابرابر
नाबालिग़	نابالغ
नाबीन	نابين
नाबूद	نابوُد
नाबूदी	نابودي
नाब्दान	نابدان
नाभ्~ईअ	ناڀيءَ
नाम	نام
नामन्ज़ूर	نامنظور
नामन्ज़ूरी	نامنظوري
नामर्द	نامرد
नामर्दु	نامرد
नामह्मान	نامهمان
नामी	نامي
नामुनासिब	نامناثب
नामुनासिब	نامناصب
नामुम्किन	ناممڪن
नामूस	ناموس
नामूस	ناموُس
नामो	نامو
नामंज़ूर	نا
नामंज़ूर	نامنظور
नाम्यारो	ناميارو
नाम्वर	نامور
नायका	نايڪا
नायक्	نايڪ
नाराज़	ناراض
नाराज़्	ناراض
नाराज़्गी	نارازگي
नाराज़्गी	ناراضگي
नाराज़्पो	ناراضپو
नारी	ناري
नारेल्	ناريل
नारो	نعرو
नारंगी	نارنگي
नालाइक	نالائڪ
नालाइक्	نالائِق
नाली	نالي
नाले	نالي
नालेरो	ناليرو
नालो	نالو
नाशक	ناشڪ
नाशानाइतो	ناشانائتو
नाशुद्नी	ناشدني
नाश्तो	ناشتو
नास	ناس
नासाज़ी	ناسازي
नासाज़्	ناساز
नासी	ناسي
नासु	ناس
नासु	ناص
नास्तिकी	ناستِڪيِ
नास्तिक्	ناستِڪ
नास्तिक्ता	ناستڪتا
नास्पाती	ناسپاتي
नास्वंत	ناسونت
नास्वंत्	ناسونت
नाहक	ناحق
नाहकी	ناحقي
नाहकु	ناحق
नाहज़म	ناهضم
नांग	نانگ
नांग	نانگَ
नांगु	نانگ
नि	نِ
निउड़त	نئڙت
निकमो	نڪمو
निकरणु	نڪرڻ
निकाहु	نقاه
निकितलु	نڪتل
निकिरणु	نڪرڻ
निक्तल	نڪتل
निक्रणु	نِڪرَڻُ
निक्रणु	نِڪرڻُ
निक्रणु	نڪرڻ
निक्री	نڪري
निगहबान	نگهبان
निगहबानी	نگهباني
निगाह	نگاه
निगाह्	نگاه
निगिरानी	نگراني
निग्रानी	نگراني
निचोड़णु	نچوڙڻ
निछ	نڇ
निजात	نجات
निज़ारेदार	نِظاريدار
निज़ारो	نظارو
निजी	نجي
निजो	نجو
निॼाणा	نڄاڻا
निठर	نٺر
निठरु	نِٺَرُ
निठरु	نٺر
निठर्	نٺر
निड़ी	نڙي
नित्नेम	نتنيم
निदा	ندا
निदार	ندار
निदोरो	ندورو
निधणिको	نڌڻڪو
निधण्को	نڌڻڪو
निधर	نڌر
निन्ड	ننڊ
निपाइणु	نپائڻ
निपुटो	نپٽو
निपूड़णो	نپوڙڻو
निपूंसक	نپوُنسڪ
निपोड़णु	نپوڙڻ
निफ़ाकु	نفاق
निफ़ाक्	نفاق
निबाताट	نباتات
निबातात	نباتات
निबात्	نبات
निबेरो	نبيرو
निभॻो	نڀاڳو
निभाॻो	نڀاڳو
निमड़्ता	نمڙتا
निमणु	نمڻ
निमाउ	نماءُ
निमाउ	نِماءُ
निमाणाई	نماڻائي
निमाणो	نماڻو
निमु	نم
नियम	نيم
नियम्	نيم
नियाज़्मंदीअ	نيازمنديءَ
नियाणी	نياڻي
नियात	نيات
नियापो	نياپو
नियंत्रण	نينترڻ
निराकार	نراڪار
निरालीअ	نراليءَ
निरालो	نرالو
निरालो	نِرالو
निराशावाद	نراشاواد
निरास	نراس
निरास	نِراس
निरासाई	نراسائي
निरासु	نراس
निरास्	نراس
निरिड़ु	نرڙ
निरूपी	نروپي
निरो	نرو
निर्खिम्या	نرکميا
निर्जन	نرجن
निर्णायक	نرڻايڪ
निर्दई	نردئي
निर्दई	نِرِدَئيِ
निर्देश	نرديش
निर्दोश	نردوش
निर्दोश्	نردوش
निर्धन्ता	نرڌنتا
निर्पक्शता	نِرِپَڪشَتا
निर्पक्श्ता	نرپڪشتا
निर्भर	نرڀر
निर्मल	نرمل
निर्मल्	نرمل
निर्माण	نرماڻ
निर्माता	نرماتا
निर्लॼो	نرلڄو
निर्वार	نروار
निर्विरोध	نروروڌ
निर्विर्ती	نرورتي
निर्विवाद्ता	نرووادتا
निलो	نلو
निवाइणु	نوائڻ
निवालो	نوالو
निवासी	نواسي
निविर्ती	نورتي
निशान	نشان
निशान	نِشان
निशानियूं	نشانيون
निशानी	نشاني
निशानी	نِشانيِ
निशानीअ	نشانيء
निशानु	نشان
निशानेबाज़	نشانيباز
निशान्	نشان
निशान्	نِشان
निशान्यूं	نشانيون
निशास्तो	نشاستو
निश्कपट	نشڪپٽ
निश्क्रिय	نشڪريَ
निश्क्र्य	نشڪريَ
निश्चल्ता	نشچلتا
निश्चो	نشچو
निश्पक्श	نشڪپٽ
निश्पक्श्	نشپڪش
निश्पाप	نشپاپ
निश्पाप्	نشپاپ
निश्फल	نشڦل
निसतो	نستو
निसारी	نساري
निसूरो	نسورو
निसंकोच	نسنڪوچ
निस्तेज	نستيج
निस्तेज्	نستيج
निस्बत	نسبت
निस्बत	نصبت
निस्बती	نسبتي
निस्वार्थी	نسوارٿي
निहठो	نهٺو
निहरो	نهرو
निहाद	نھاد
निहादी	نھادي
निहायत	نهايت
निहायत्	نھايت
निहायत्	نهايت
निहारणु	نهارڻ
निहाल्	نھال
निंड	ننڊ
निंडाइतो	ننڊائتو
निंडाखिड़ो	ننڊاکرو
निंडाख्ड़ो	ننڊاکڙو
निंदणु	نندڻ
निंदा	نندا
निंदात्मक	ننداتمڪ
नीअत	نيئت
नीच	نيچ
नीचु	نيچ
नीच्ता	نيچتا
नीच्पाई	نيچپائي
नीज़ारी	نيزاري
नीज़ारी	نيظاري
नीज़ारीअ	نيزاريءَ
नीति	نيتي
नीती	نيتي
नीतीवादी	نيتيوادي
नीम	نيم
नीरस	نيرس
नीरस्ता	نيرستا
नीरु	نير
नीरु	نيِرُ
नीरो	نيرو
नील	نيل
नीलम	نيلم
नीलाम	نيلام
नीलाम्	نيلام
नील्मणी	نيلمڻي
नीस्ती	نيستي
नींगरु	نينگر
नींड	نينڊَ
नुकिसान्	نقصان
नुक्तचीनी	نقتَچيني
नुक्तचीनी	نُقتَچيِنيِ
नुक्तो	نڪتو
नुक्तो	نقطو
नुक्स	نقص
नुक्सान	نقصان
नुक्सानु	نقصان
नुक्सान्	نقصان
नुक्सान्कार	نقسانڪار
नुक्सान्कार	نقصانڪار
नुक्सान्कार	نُقصانڪار
नुख़्सु	نخص
नुमाइन्श	نمائش
नुमाइश	نمائش
नुमाइशी	نمائشي
नुमाउ	نماءُ
नुस्ख़ो	نسخو
नूस	نوس
नूस	نوُس
नूसणु	نوسڻ
नेक	نيڪ
नेकाल	نيڪال
नेकाली	نيڪالي
नेकाली	نيڪاليِ
नेकालु	نيڪال
नेकी	نيڪي
नेक्नाम	نيڪنام
नेक्नामी	نيڪنامي
नेठि	نيٺ
नेम	نيم
नेमाइतो	نيمائتو
नेमु	نيم
नेव्लो	نيولو
नेशु	نيش
नैमती	نعمتي
नोक	نوڪ
नोक्दार	نوڪدار
नोक्रीअ	نوڪريء
नोटु	نوٽ
नोड़ी	نوڙي
नोतो	نوتو
नोरीअड़ो	نوريئڙو
नोरु	نور
नौकर	نوڪر
नौकरु	نوڪر
नौकर्	نوڪر
नौकिरीअ	نوڪريء
नौक्री	نوڪري
नौक्री	نَوڪري
नौक्रीअ	نوڪريء
नौक्रीअ	نوڪريءَ
नौक्रीअ	نَوڪريءِ
नौक्र्याणी	نوڪراڻي
नौजवानु	نوجوان
नंगु	نانگ
नंगो	ننگو
नंडो	نَنڊو
नंढन	ننڍن
नंढपिणु	ننڍپڻ
नंढा	ننڍا
नंढिड़ो	ننڊڙو
नंढी	ننڍي
नंढे	ننڍي
नंढो	ننڍو
नंढ्ड़ो	ننڍڙو
नंढ्पिणु	ننڍپڻ
नंढ्यूं	ننڍيون
नंहन	ننھن
नंहुं	ننهن
न्याउ	نياءُ
न्याणो	نياڻو
न्यात	نيات
न्यापो	نياپو
न्याय	نياي
न्यारो	نيارو
पक	پَڪَ
पक	پڪ
पकल	پڪل
पकलु	پڪل
पकिड़णु	پڪڙڻ
पकी	پڪي
पको	پڪو
पक्ड़णु	پڪڙڻ
पक्ड़ींदड़्	پڪڙيندڙ
पक्ड़े	پڪڙي
पखिड़णु	پکڙڻ
पखिड़िजी	پکڙجي
पखिड़्यल	پکڙيل
पखियुं	پکين
पखी	پکي
पखु	پَکُ
पखेड़	پکيڙ
पखेड़	پَکيڙَ
पखेड़णु	پکيڙڻ
पख्इयुन्या	پکين
पख्ड़णु	پکڙڻ
पख्ड़न्दड़्	پکڙندڙ
पख्ड़्यल	پکڙيل
पख्युन	پَکِيُن
पघर	پگھر
पघरु	پگھر
पघार	پگھار
पघिर्जणु	پگھرجڻ
पचणु	پچڻ
पचाइणु	پچائڻ
पचु	پچ
पचो	پچو
पचो	پَڇو
पछाड़ी	پَڇاڙي
पछाड़ी	پڇاڙي
पछाड़ीअ	پڇاڙيءَ
पछाड़ीअ	پچاڙيءَ
पछिमी	پڇمي
पछिमु	پڇم
पछ्ताइणु	پڇتائڻ
पछ्ताउ	پڇتاءُ
पट	پٽ
पटणु	پٽڻ
पटाटो	پٽاٽو
पटापटी	پَٽاپَٽيِ
पटापटी	پٽاپٽي
पटांदड़्	پٽاندڙ
पटिड़ो	پٽڙو
पटी	پٽي
पटु	پٽ
पटे	پٽي
पटेदार	پٽيدار
पटेवालो	پٽيوالو
पटो	پٽو
पड़ाॾो	پڙاڏو
पड़ाव्	پڙاو
पड़ी	پَڙيِ
पड़ो	پڙو
पड़्डो	پڙدو
पड़्ताल्	پڙتال
पड़्दे	پڙدي
पड़्दो	پڙدو
पड़्ह	پَڙِھَ
पड़्ह	پڙھ
पड़्हण	پڙھڻ
पड़्हण	پڙهڻ
पड़्हणु	پڙهڻ
पड़्हाइणु	پڙهائڻ
पड़्हाई	پڙهائي
पड़्हाणी	پڙهاڻي
पड़्हियल	پَڙهِيَل
पड़्ही	پڙهي
पड़्हंदड़	پڙهندڙ
पड़्हंदड़्	پڙھندڙ
पड़्ह्यल	پڙهيل
पॾणु	پڏڻ
पॾाइणु	پڏائڻ
पणी	پاڻي
पतणु	پتڻ
पतिराई	پترائي
पतिलो	پتلو
पती	پتي
पतीअ	پتيءَ
पते	پتي
पतो	پتو
पतंगो	پتنگو
पत्नी	پتني
पत्र	پتر
पत्रकार्	پترڪار
पत्रु	پتر
पत्रो	پترو
पत्र्	پتر
पथर	پٿر
पथरु	پٿر
पथर्	پَٿَر
पथर्	پٿر
पथ्री	پَٿِريِ
पदक	پدڪ
पदारथ	پدارٿ
पदार्थ	پدارٿ
पदार्थु	پدارٿ
पदार्थ्	پدارٿ
पदु	پد
पद्यात्रा	پدياترا
पद्राई	پڌرائي
पद्वी	پدوي
पधर्	پڌر
पधिरो	پڌرو
पध्ड़ो	پڌرو
पध्राई	پڌرائي
पध्रो	پڌرو
पन	پن
पननि	پنن
पनाह	پناھ
पनाह	پناه
पनीर्	پنير
पनो	پَتِرُ
पनो	پنو
पनो	پَنو
पन्चकी	پنچڪي
पन्चु	پنچ
पन्जो	پنجو
पन्द्रंह्	پندرهن
पपेर	پيپر
पप्ड़ी	پپڙي
पम्पु	پمپ
पर	پر
परख	پرک
परणु	پرڻ
परतिमा	پرتما
परपुठ	پرپٺ
परपुठि	پرپٺ
परम	پرم
परमतिड़्यो	پرمتڙيو
परमाणू	پرماڻو
परम्परा	پرمپرا
परम्परा	پَرَمپَرا
परवरिश	پرورش
पराओ	پرائو
पराक्रम	پراڪرم
परावर्तक	پراورتڪ
परिएं	پَرئين
परिण्यल	پرڻيل
परिभाशिकी	پرڀاشڪ
परी	پري
परीख्या	پريکيا
परीवर्तन	پريورتن
परीवार	پريوار
परीवार्	پريوار
परु	پر
परु	پَرُ
परुप्कारी	پراُپڪاري
परूड़	پَروُڙَ
परे	پري
परे	پَري
परे	پي
परेड	پريڊ
परेशान	پريشان
परेशानी	پريشاني
परेशानु	پريشان
पर्ख	پرک
पर्खणु	پرکڻ
पर्ख्यल	پرکيل
पर्ॻणो	پرڳڻو
पर्ॻिणन	پرڳِڻن
पर्चाइणु	پرچائڻ
पर्चाउ	پرچاءُ
पर्चाणी	پرچاڻي
पर्चून	پرچون
पर्चो	پرچو
पर्चो	پَرِچو
पर्जीवी	پرجيوي
पर्तु	پرت
पर्ते	پرتي
पर्देस	پرديس
पर्देसी	پرديسي
पर्देसी	پَرديسيِ
पर्देस्	پرديس
पर्दो	پردو
पर्द्सी	پرديسي
पर्बत	پربت
पर्ॿंध्	پرٻنڌ
पर्माणे	پَرِماڻيِ
पर्मात्मा	پَرماتما
पर्मार्थी	پرمارٿي
पर्यां	پَيان
पर्लाउ	پرلاءُ
पर्लोक	پرلوڪ
पर्वरिश	پرورش
पर्वान्गी	پروانگي
पर्वाह	پرواه
पर्वाही	پرواسي
पर्हेज़	پرھيز
पर्हेज़्गार	پرهيزگار
पल	پل
पलट	پلٽ
पलट्वारु	پلٽوار
पलान्^	پلاڻ
पलालु	پلال
पलीत	پليت
पलीताई	پليتائي
पलु	پل
पलौ	پلءُ
पल्टाइणु	پلٽائڻ
पल्थी	پلٿي
पवणि	پوڻ
पवणु	پوڻ
पवण्	پوڻ
पवनु	پَوَن
पविट्र	پَوِتَر
पवितर	پَوِتَرِ
पवित्र	پوتر
पवित्रता	پوترتا
पवंदड़	پوندڙ
पवंदड़्	پوندڙ
पव्तर	پوتر
पशम्	پشم
पशम्दार	پشمدار
पशेमान	پشيمان
पशेमानी	پشيماني
पश्मी	پشمي
पसणु	پسڻ
पसन्द्	پسند
पसा	پاسا
पसारणु	پسارڻ
पसारी	پساري
पसिगिर्दाई	پسگردائي
पसिर्जणु	پسرجڻ
पसीनो	پسينو
पसु	پس
पसुन	پسن
पसूं	پسون
पसूं	پَسوُن
पसूंअ	پَسوُنءُ
पसंद	پسند
पसंदी	پسند
पसंदी	پسندي
पसंद्	پسند
पस्गिर्दाई	پسگردائي
पस्मंज़र	پسمنظر
पस्रो	پسرو
पहड़ी	پھاڙي
पहणु	پهڻ
पहल	پهل
पहल्वान	پهلوان
पहल्वानु	پهلوان
पहाको	پهاڪو
पहाड़ी	پھاڙي
पहाड़ी	پهاڙي
पहाड़ु	پهاڙ
पहिन्जाई	پنهنجائي
पहिरणु	پهرڻ
पहिरियों	پهريون
पहिरीं	پهرين
पहिरो	پهرو
पहिर्याईं	پهريائين
पहिर्यों	پھريون
पहिर्यों	پَھِرِيون
पहिर्यों	پهريون
पहिलिवानी	پهلواني
पहिल्वान्	پَهِلوان
पहिंजी	پھنجي
पहिंजी	پنهنجي
पहुच	پَھُڇَ
पहुच	پَھُچَ
पहुच	پھچ
पहुच	پهچ
पहुच	پَهُچَ
पहुचणु	پھچڻ
पहुचणु	پهچڻ
पहुचणु	پهُچڻُ
पहुचाइणु	پھچائڻ
पहुचाइणु	پهچائڻ
पहुह्चणु	پھچڻ
पह्चाण	پَهچاڻَ
पह्रीं	پھرين
पह्रेदार	پهريدار
पह्रो	پهرو
पह्ल्वान्	پھلوان
पाअरस	پارس
पाइणु	پائِڻُ
पाइणु	پائڻ
पाइणु	پڱئڻ
पाइदारी	پائداري
पाइबंदी	پائبندي
पाइमाल्	پائمال
पाईप	پائيپ
पाईंदड़	پائيندڙ
पाक	پاڪ
पाकी	پاڪي
पाक्	پاڪِ
पाखंड	پاکنڊ
पाखंडी	پاکنڊي
पाखंडु	پاکنڊ
पाखंड्	پاکنڊ
पाॻल	پاڳل
पाॻल्	پاڳل
पाॻल्पणो	پاڳلپڻو
पाछी	پاڇي
पाछो	پاڇو
पाञारी	پاڃاري
पाटियो	پاٽيو
पाठ	پاٺ
पाठक	پاٺڪ
पाठु	پاٺ
पाठ्	پاٺ
पाठ्यक्रम	پاٺيڪرم
पाठ्शाला	پاٺشالا
पाड़	پاڙ
पाड़हणु	پاڙهڻ
पाड़ून	پاڙون
पाड़ूं	پاڙون
पाड़े	پاڙي
पाड़ेस्री	پاڙيسري
पाड़ो	پاڙو
पाड़्हण	پاڙهڻ
पाड़्हणु	پاڙهڻ
पाण	پاڻ
पाण	جي
पाणही	پاڻهي
पाणी	پاڻي
पाणीअ	پاڻي
पाणीअ	پاڻيء
पाणीअ	پاڻيءَ
पाणु	پاڻ
पाणेही	پاڻيهي
पाणेही	پاڻيهيِ
पाणेही	پاڻيھيِ
पाण्याठी	پاڻِياٺيِ
पाण्याठो	پاڻياٺو
पाण्याठ्	پاڻياٺ
पाण्ही	پاڻھي
पातल	پاتل
पादिरियुन	پادرين
पाद्री	پادري
पाप	پاپ
पापी	پاپي
पापु	پاپ
पाप्	پاپ
पाबंद	پائبند
पाबंदीअ	پائبنديءَ
पायो	پايو
पार	پار
पारत	پارت
पारतो	پارتو
पारां	پاران
पारूथो	پاروٿو
पारो	پارو
पार्	پار
पार्खू	پارکوُ
पार्दर्शक	پاردرشڪ
पार्दर्शक्ता	پاردرشڪتا
पार्सल	پارسل
पाल	پال
पालक	پالڪ
पालणु	پآلَڻُ
पालणु	پالڻ
पालिका	پالڪا
पालियलु	پاليل
पालिश्	پالش
पालिश्दार	پالشدار
पाल्तू	پالتو
पाल्ना	پالنا
पाल्यल	پاليل
पास	پاس
पासा	پاسا
पासी	پاسيِ
पासीरो	پاسيرو
पासे	پاسي
पासो	پاسو
पास्	پاس
पास्ख़ात्री	پاسخاتري
पास्ख़ात्री	پاسخاطري
पास्ख़ात्री	پاسخاطريِ
पास्ख़ात्रीअ	پاسخاطريءَ
पास्वर्ड	پاسورڊ
पिक	پڪ
पिक्चर	پڪچر
पिघरणु	پگھرڻ
पिघिरणु	پگھرڻ
पिच	پِِچ
पिच्किड़ो	پچڪڙو
पिछिड़्यल	پڇڙيل
पिछ्ड़णु	پڇڙڻ
पिॼिरो	پڃرو
पिञिरो	پڃرو
पिट	پٽ
पिटणु	پٽڻ
पिट्यलु	پٽيل
पिड़ी	پڙي
पिणि	پڻ
पिणो	پڻو
पितल्	پتل
पिता	پتا
पितापिणो	پتاپڻو
पितु	پِتُ
पिन	پن
पिनणु	پنڻ
पिनत्	پِنَت
पियणु	پيڻ
पियल्	پيل
पियाक	پياڪ
पियाकु	پياڪ
पियार	پيار
पियारणु	پيارڻ
पियाला	پيالا
पिरायल्	پِرايَل
पिरीं	پرين
पिरोली	پرولي
पिर्घट	پرگھٽ
पिर्ह	پڙھ
पिस्तोल	پستول
पिंग्लो	پنگلو
पिंञिरो	پنڃرو
पिंबिड़ी	پِنبِڙِي
पी	پي
पीअण	پيئڻ
पीअणु	پيئڻ
पीअणु	پيِئَڻُ
पीउ	پيءٌ
पीउ	پيءُ
पीछो	پيڇو
पीठलु	پيٺل
पीठल्	پيٺل
पीड़	پيڙه
पीड़णु	پيڙڻ
पीड़ा	پيڙا
पीड़ींदड़्	پيڙيندَڙ
पीड़े	پيِڙي
पीड़्हि	پيڙه
पीड़्ही	پيڙھي
पीतो	پيتو
पीपु	پيپ
पीलाण	پيلاڻ
पीले	پيلي
पीलो	پيلو
पील्पाओ	پيلپائو
पीसणु	پيسڻ
पीह	پيِهَ
पीहो	پيهو
पींघो	پينگھو
पुकारणु	پڪارڻ
पुख़िताई	پُخِتائيِ
पुख़्ताई	پختائي
पुख़्ताईअ	پختائيءَ
पुख़्तो	پختو
पुछ	پُڇُ
पुछ	پڇ
पुछणु	پڇڻ
पुछा	پُڇا
पुछा	پڇا
पुछु	پڇ
पुछ्	پڇ
पुछ्ड़ी	پڇڙي
पुछ्यो	پُڇيو
पुॼणु	پڄڻ
पुॼाणी	اَنتُ
पुॼाणी	پڄاڻي
पुटु	پٽ
पुठ	پُٺ
पुठ	پٺ
पुठि	پٺ
पुठिते	پٺتي
पुठियां	پٺيان
पुठियों	پٺيون
पुठी	پٺي
पुठीअ	پٺيءَ
पुठीं	پٺين
पुठो	پٺو
पुठ्ते	پٺتي
पुठ्भराई	پٺڀرائي
पुठ्यां	پٺيان
पुठ्यों	پٺيون
पुड़ीको	پڙيڪو
पुड़ु	پڙ
पुण्यवान	پڻيوان
पुतिलो	پتلو
पुत्लो	پتلو
पुत्लो	پُتلو
पुथल	پٿل
पुनर	پنر
पुनर्वास	پنرواس
पुनो	پنو
पुफी	ٻڦي
पुरणो	پراڻو
पुराण	پراڻ
पुराणिक	پراڻڪ
पुराणे	پراڻي
पुराणो	پراڻو
पुराणो	پُراڻو
पुराण्कठा	پراڻ
पुरुश	پرش
पुर्ज़ा	پرزا
पुर्ज़े	پرزي
पुर्ज़ो	پرزو
पुर्जोश	پُرجوش
पुल	پل
पुलट	پلٽ
पुलि	پل
पुलिन्ग	پلنگ
पुलीस	پليس
पुश्टु	پشٽ
पुश्पु	پشپ
पुसाइणु	پسائڻ
पुस्तक	پستڪ
पुस्त्कालय्	پستڪاليَ
पुस्यलु	پسيل
पूज्य	پوُجِيَ
पूॼ	پوڄ
पूॼणु	پوڄڻ
पूॼा	پوڄا
पूॼा	پوجا
पूॼारी	پوڄاري
पूतो	پوتو
पूर	پور
पूरणु	پورڻ
पूरणु	دَفَن
पूरन्ता	پورنتا
पूरब	پورب
पूरबु	پورب
पूराई	پورائي
पूराओ	پورائو
पूरालो	پورالو
पूरी	پوري
पूरी	پوُريِ
पूरी	پوريءَ
पूरीअ	پوريءَ
पूरु	پور
पूरु	پوُر
पूरे	پوري
पूरो	ڦاسي
पूरो	پورو
पूरो	پوُرو
पूरोपुनो	پوروپنو
पूर्णत	پورڻتا
पूर्णता	پورڻتا
पूर्ण्ता	پورڻتا
पूर्ती	پورتي
पूर्बी	پوربي
पूंग्ड़ा	پونگڙا
पूंग्ड़ो	پونگڙو
पूंजी	پونجي
पेच	پيچ
पेचीदो	پيچيدو
पेचु	پيچ
पेचु	پيچُ
पेच्दार	پيچدار
पेच्दार्	پيچدار
पेच्रो	پيچرو
पेजु	پيج
पेट	پيٽ
पेटीकोट	پيٽيڪوٽ
पेटु	پيٽ
पेटू	پيٽو
पेटोरी	پيٽوري
पेती	پيتي
पेती	پيٽي
पेतीअ	پيتيءَ
पेन	پين
पेनी	پيني
पेन्सिल	پينسل
पेर	پير
पेर	پيرَ
पेरन	پيرن
पेरु	پيرُ
पेरें	پيرين
पेरो	پيرو
पेर्वी	پيروي
पेर्वीअ	پيرويءَ
पेवन्द	پيوَند
पेश	پيش
पेशानी	پيشاني
पेशाब	پيشاب
पेशाबु	پيشاب
पेशि	پيشي
पेशेवर	پيشيور
पेशो	پيشو
पेश्गी	پيشگي
पेस्ट	پيسٽ
पैकिंग	پيڪنگ
पैकेट	پيڪيٽ
पैग़म्बर	پيغمبر
पैग़ाम्	پيغام
पैदा	پيدا
पैदा	پَيدا
पैदाइश	پيدائش
पैदाइश्	پَيدائش
पैदावार	پيداوار
पैदावारी	پيداواري
पैदावार्	پيداوار
पैदाश	پيدائش
पैमाइश	پَيمائش
पैमानो	پئمانو
पैसा	پئسا
पैसा	پيسا
पैसा	پَيسا
पैसे	پئسي
पैसे	پيسي
पैसे	پيَسي
पैसो	پَيسو
पैंच	پئنچ
पैंचु	پئنچ
पोइ	پوء
पोइ	پوءِ
पोइते	پؤئِتي
पोइते	پوئتي
पोइलॻु	پوءِلڳ
पोइलॻु	پوئلڳ
पोइवारी	پؤواري
पोइवारी	پوئواري
पोइवारी	پوئواريِ
पोख	پوک
पोखणु	پوکڻ
पोखींदड़	پوکيندڙ
पोचो	پوچو
पोटी	پوٽي
पोटो	پوٽو
पोपट्	پوپٽ
पोयां	پويان
पोयूं	پويون
पोयों	پويون
पोरो	پورو
पोर्ट	پورٽ
पोर्ह्यत्	پورھيت
पोर्ह्यो	پورگيو
पोर्ह्यो	پورهيو
पोलु	پول
पोश	پوش
पोशाक	پوشاڪ
पोशाक	پوشاڪَ
पोशाक्	پوشاڪ
पोशी	پوشي
पोशीदो	پوشيدو
पोशु	پوش
पोश्	پوش
पोसल	پوسل
पोसिराइणु	پوسرائڻ
पोसिरंदड़	پوسرندڙ
पोसिलो	پوسيلو
पोस्राईंदड़्	پوسرائيندڙ
पंख	پَنک
पंखिड़ी	پنکڙي
पंखु	پَنکُ
पंखुड़ी	پنکڙي
पंगती	پنگتي
पंगत्	پنگت
पंज	پنج
पंजो	پنجو
पंजों	پنجون
पंथी	پنٿي
पंथु	پنٿ
पंध	پَنڌَ
पंधि	پنڌ
पंधु	پنڌ
पंहिन्जो	پنهنجو
पंहिंजाई	پنهنجائي
पंहिंजी	پنهنجي
पंहिंजे	پنھنجي
पंहिंजो	پنهنجو
प्अहुचाइणु	پھچائڻ
प्यल	پيل
प्यलु	پيل
प्याज़	پياز
प्यादी	پيادي
प्यादो	پيادو
प्यार	پيار
प्यारणु	پيارڻ
प्यारी	پيارو
प्यारु	پيار
प्यारो	پيارو
प्यारो	پِيارو
प्यारो	پياري
प्यार्	پيار
प्यालो	پيالو
प्यास	پياس
प्यो	پيو
प्रकारन	پرڪارن
प्रकाश	پرڪاش
प्रकाशक	پرڪاشڪ
प्रकाशन	پرڪاشن
प्रकाशित	پرڪاشت
प्रकोप	پرڪوپ
प्रचार	پرچار
प्रचारक	پرچارڪ
प्रजा	پرجا
प्रणाम	پرڻام
प्रताप	پرتاپ
प्रतापी	پرتاپي
प्रताब्	پرناب
प्रथा	پرٿا
प्रदूशणु	پردوشڻ
प्रधान	پرڌان
प्रफुल्ता	پرڦلتا
प्रॿंधक	پرٻنڌڪ
प्रभात	پرڀات
प्रभावी	پرڀاوي
प्रभाव्	پرڀاو
प्रमाण	پرماڻ
प्रमाणु	پرماڻ
प्रवचन	پروچن
प्रवाह	پرواه
प्रवेश	پرويش
प्रवेश	پويش
प्रशन	پرشن
प्रश्नावली	پرشناولي
प्रसन्ता	پرسنتا
प्रसारणु	پرسارڻ
प्रस्ताव	پرستاو
प्राचीन	پراچين
प्राण	پراڻ
प्राणु	پراڻ
प्राण्	پراڻ
प्राप्त	پراپت
प्रार्थ्ना	پرارٿنا
प्राल्ॿध	پرالٻڌ
प्रास्चित	پراسچت
प्रास्चित्	پراسڇت
प्रांत	پرانت
प्रांतिक	پرانتڪ
प्रांतियता	پرانتيتا
प्रांतु	پرانت
प्रिय	پريَ
प्रिह	پِرَهَ
प्रीत	پريت
प्रीतम	پريتم
प्रीत्	پريت
प्रीत्यो	پريتيو
प्रूफ़	پروف
प्रेत्वादु	پريتواد
प्रेत्साधक	پريتساڌڪ
प्रेम	پريم
प्रेमिका	پريمڪا
प्रेम्	پريم
प्रेरक	پريرڪ
प्रेरणा	پريرڻا
प्रेरणु	پريرڻ
प्रेरित	پريرت
प्रेर्णा	پريرڻا
प्रोफ़ेसर	پروفيسر
प्र्योग्शाला	پريوگشالا
प्लेट	پليٽ
फ़कत	فقت
फ़कत	فقط
फ़कत	فَقَط
फकी	ڦڪي
फ़कीर	فقير
फ़ज़ीलत	فَزيِلَت
फ़ज़ीलत	فضيلت
फ़ज़ीलत	فَضيِلَت
फ़ज़ीलत्	فَزيِلَت
फ़ज़ीलत्	فضيلت
फ़जुर्	فجر
फ़ज़ूल	فضول
फट	ڦٽ
फटाको	ڦٽاڪو
फटु	ڦٽ
फटु	پٽ
फट्कनि	ڦٽڪن
फट्का	ڦٽڪا
फट्कार	ڦٽڪار
फट्कारणु	ڦٽڪارڻ
फट्कार्	ڦٽڪار
फट्को	ڦٽڪو
फड़्कणु	ڦڙڪڻ
फॾई	ڦڏئي
फणी	ڦڻي
फणु	ڦڻ
फ़तह	فتح
फ़तहयाब	فتحياب
फथिकणु	ڦٿڪڻ
फथ्फथ्यो	ڦٿڦَٿيو
फ़न	فن
फ़ना	فنا
फ़नु	فن
फ़नूस्	فانوس
फफूंड	ڦڦوند
फॿाइणु	ڦَٻائِڻُ
फॿाइणु	ڦٻائڻ
फ़रकु	فرق
फ़रामोश	فراموش
फ़रिश्तो	فرشتو
फरु	ڦر
फ़रेब	فريب
फ़रेबी	فريبي
फ़रेबु	فريب
फ़रेब्	فريب
फ़र्कु	فرق
फ़र्ज़	فرض
फ़र्ज़ी	فرضي
फ़र्ज़ी	فَرِضيِ
फ़र्ज़ु	فرض
फ़र्ज़ंदु	فرزند
फ़र्निचर	فرنيچر
फ़र्नीचर्	فرنيچر
फ़र्मानु	فرمان
फ़र्मान्	فرمان
फ़र्मान्दारी	فرمانداري
फ़र्मान्बर्दारी	فرمانبرداري
फ़र्यादी	فريادي
फ़र्श	فرش
फ़र्शी	فرشي
फ़र्शु	فَرشَ
फ़र्हत	فرحت
फ़र्हत	فرهت
फ़र्हती	فرهتي
फल	ڦل
फलणु	ڦلڻ
फ़लाणो	فلاڻو
फलु	ڦل
फ़साद	فساد
फ़सादी	فسادي
फ़सादु	فساد
फ़साद्	فساد
फ़सानो	فسانو
फ़सुलु	فصل
फ़सुल्	فصل
फह	ڦه
फ़हम	فهم
फ़हमु	فهم
फहिके	ڦهڪي
फहिको	ڦهڪو
फ़हिमीदो	فهميدو
फ़हिर्स्त	فھرست
फहिलाइणु	ڦهلائڻ
फहिलाउ	ڦهلاءُ
फहिलाउ	ڦهلاِءُ
फहिल्जणु	ڦھِلجڻ
फहिल्जणु	ڦهلجڻ
फहिल्जी	ڦھلجي
फहिल्जंदड़	ڦهلجندڙ
फहिल्यल	ڦهليل
फहिल्यलु	ڦھليل
फहिल्यलु	ڦهليل
फह्काइणु	ڦهڪائڻ
फह्काए	ڦهڪائي
फ़ह्मी	فهمي
फह्राइणु	ڦھرائڻ
फ़ह्रिस्त्	فھرست
फह्लाइणु	ڦهلائڻ
फह्लाउ	ڦهلاءُ
फ़ाइदे	فائدي
फ़ाइदेमंड	فائديمند
फ़ाइदेमंद	فائديمند
फ़ाइदेमंदी	فائديمندي
फ़ाइदेवारो	فائديوارو
फ़ाइदो	فائدو
फ़ाइदो	فَائِدو
फ़ाइल	فاعل
फ़ाईल	فائيل
फाक	ڦاڪ
फ़ाको	فاڪو
फाटक	ڦاٽڪ
फाटणु	ڦاٽڻ
फाटी	ڦاٽي
फाटु	ڦاٽ
फाटो	ڦاٽو
फाड़	ڦاڙَ
फाड़णु	ڦارڻ
फाड़णु	پاڙهڻ
फाड़ु	ڦاڙ
फाड़े	ڦاڙي
फाड़्	ڦاڙَ
फ़ानी	فاني
फ़ानी	فانيي
फारे	ڦاڙي
फ़ाल्टू	فالٽو
फ़ाल्तू	فالتو
फ़ाल्तू	فالتوُ
फ़ाल्सू	فالسو
फासणु	ڦاسَڻُ
फासाइणु	ڦاسائِڻ
फासाइणु	ڦاسائِڻُ
फासाइणु	ڦاسائڻ
फासी	ڦاسي
फासी	پورو
फासीअ	ڦاسيءَ
फ़ास्लो	فاصلو
फ़ाहिश	فاحش
फ़ाहिश	فاهش
फ़ाहिश्	فاحش
फिकत	ڦڪت
फ़िकर्मंद	فڪرمند
फिको	ڦڪو
फ़िज़ूल	فضول
फिटनु	ڦِٽَڻُ
फिटलु	ڦٽل
फिटाइणु	ڦٽائڻ
फिटो	ڦٽو
फिट्कार्	ڦٽڪار
फिॾो	ڦِڏو
फ़ितिरती	فطرتي
फ़िदा	فدا
फिफिड़	ڦڦڙ
फिफिड़ु	ڦڦڙ
फिफिड़ो	ڦڦڙو
फिरणु	ڦرڻ
फिरिणो	ڦرڻو
फिरियल	ڦريل
फिरी	ڦري
फ़िरोश्	فروش
फिरौती	ڦروتي
फिरंडड़ु	ڦرندڙ
फिरंदड़	فرندڙ
फिरंदड़ु	ڦرندڙ
फिरंदड़्	ڦرندڙ
फिरंदी	ڦرندي
फिर्की	ڦرڪي
फ़िर्को	فرقو
फिर्यल	ڦريل
फ़िलासाफ़ी	فلاسافي
फ़िल्म	فلم
फ़िहरिस्त	فهرست
फ़िह्रिस्त	فھرست
फ़ी	في
फीण	ڦيڻ
फीणि	ڦيڻ
फीणो	ڦيڻو
फीथ	ڦيٿ
फीथो	ڦيٿو
फ़ुट	فُتَ
फुटणु	ڦٽڻ
फुटी	ڦُٽيِ
फुटी	ڦٽي
फुट्कर	ڦٽڪر
फुड़	ڦڙ
फुड़ी	ڦڙي
फुड़ो	ڦڙو
फुड़्	ڦڙ
फुड़्टु	ڦڙت
फुड़्त	ڦڙت
फुड़्ताई	ڦڙتائي
फुड़्ती	ڦڙتي
फुड़्तीअ	ڦڙتيءَ
फुड़्तीलो	ڦڙتيلو
फुड़्तु	ڦرت
फुड़्त्	ڦڙت
फुफ्कार	ڦڦڪار
फुर	ڦر
फुर	ڦُرَ
फुरणु	ڦڙڻ
फुरणु	ڦرڻ
फुर्णो	ڦرڻو
फुर्तु	ڦُڙتُ
फुर्तु	ڦڙت
फुर्मार	ڦرمار
फ़ुर्सत	فرست
फ़ुर्सत्	فرصت
फुलगोबी	ڦلگوبي
फुलो	ڦلو
फुस्फुसाइणु	ڦسڦسائڻ
फुस्लाइणु	ڦسلائڻ
फुस्लाईंदड़	ڦسلائيندڙ
फुहार	ڦهار
फुंडणु	ڦنڊڻ
फुंडाइणु	ڦنڊائڻ
फुंड्यल	ڦنڊيل
फुंड्यलु	ڦنڊيل
फूक	ڦوڪ
फूकणु	ڦوڪڻ
फूक्णो	ڦوُڪڻو
फूद्नो	ڦودنو
फूलणु	ڦوُلڻ
फूल्दानु	ڦولدان
फूह	ڦوھ
फूहारो	ڦوهارو
फूंड	ڦوُنڊ
फूंड	ڦوندَ
फूंडिजणु	ڦوُنڊجڻ
फेटाड़ो	ڦيثاڙو
फेटारो	ڦيٽارو
फेड़	ڦيڙ
फेणि	ڦيڻ
फेफो	ڦيڦو
फेर	ڦير
फेरणु	ڦيرڻ
फेराइणु	ڦيرائڻ
फेराए	ڦيرائي
फेरी	ڦيري
फेरीअ	ڦيريءَ
फेरु	ڦير
फेरे	ڦيري
फेरो	ڦيرو
फेरो	ڦيروآ
फ़ेरोज़ी	فروزي
फेर्घेरि	ڦيرگھير
फेर्फार	ڦيرڦار
फ़ेल्सूफ़	فيلسوف
फ़ेल्सूफ़ीअ	فيلسوفيءَ
फ़ेस्लो	فيصلو
फ़ैन्सी	فَئِنسيِ
फैलाउ	ڦَيلاءٌ
फ़ैशन्	فَيشن
फ़ैसलो	فيصلو
फ़ैस्ले	فيصلي
फ़ैस्लो	فيصلو
फोॻु	ڦوڳ
फोटि	ڦوٽِ
फ़ोटो	فوٽو
फोटो	ڦوٽو
फ़ोटो	ڦوٽو
फोड़ू	ڦوڙو
फोफींडो	ڦوڦينڊو
फोरी	ڦوري
फोरू	ڦورو
फोरू	ڦوروُ
फ़ोर्मूला	فارمولا
फोल्हणु	ڦولهڻ
फ़ौज	فوج
फ़ौज	فَوج
फ़ौजी	فوجي
फ़ौजी	فوجيِ
फ़ौजी	فَوجي
फ़ौज्दारी	فوجداري
फ़ौरन्	فَورن
फ़ौलादु	فولاد
फंदो	ڦندو
ब	ب
ब	بَ
बक	بڪ
बकणु	بڪڻ
बकाया	بقايا
बकि	بڪ
बकियो	بڪيو
बक्बक	بڪبڪ
बक्बकियो	بڪبڪيو
बक्बक्यो	بڪبڪيو
बक्यो	بڪيو
बक्वासी	بڪواسي
बक्वास्	بڪواس
बक्शणु	بڪشڻ
बक्शीश	بخشيش
बख़ूबी	بخوبي
बखेड़ाई	بکيڙائي
बख़्मल	بخمل
बख़्शणु	بخشڻ
बख़्शीश	بخشيش
बग़ल	بغل
बग़ल	بَغَل
बग़ावत	بغاوت
बग़ावत्	بغاوت
बघड़ु	بگھڙ
बघेड़ु	بگھيڙ
बचणु	بچڻ
बचत	بچت
बचति	بچت
बचाइणु	بچائڻ
बचाईंदड़	بچائيندڙ
बचाईंदड़ु	بچائيندڙ
बचाउ	بچاء
बचाउ	بچاءُ
बचाए	بچائي
बच्यल	بچيل
बच्यलु	بچيل
बच्यल्	بچيل
बजाइ	بجاءِ
बज़ार	بزار
बजि	بج
बजिरु	بجر
बज्री	بجري
बञणु	ڀڃڻ
बटणु	بٽڻ
बठी	بَٺيِ
बठी	بٺي
बड़	بڙ
बड़्बड़ाइणु	بڙبڙائڻ
बड़्बड़्	بڙبڙ
बड़्बड़्यो	بڙبڙيو
बणाइणु	بڻائڻ
बणाइणु	بنڻائِڻُ
बणाउ	بڻاءُ
बणिजणु	بڻجڻ
बती	بتي
बती	بَتيِ
बतीअ	بتيءَ
बद	بد
बदक	بدڪ
बदन	بدن
बदन	بدَنَ
बदन्	بدن
बदल	بدل
बदल	بَدَلِ
बदसर्	بداثر
बदिल्जणु	بدلجڻ
बदिल्जंदड़	بدلجندڙ
बदिंत्ज़ामी	بدانتظامي
बद्कार	بدڪار
बद्कारी	بدڪاري
बद्किस्मत	بدقسمت
बद्ख़्वाह	بدخواه
बद्ख़्वाही	بدخواهي
बद्चाल	بدچال
बद्ज़ेबाई	بدزيبائي
बद्ज़ेबो	بدزيبو
बद्तमीज़	بدتميز
बद्तमीज़ी	بدتميزي
बद्तमीज़्	بدتميز
बद्तर	بدتر
बद्तरीन	بدترين
बद्नसीब	بدنصيب
बद्नाम	بدنام
बद्नामी	بدنامي
बद्नामीअ	بدناميءَ
बद्नामीअ	بدناميءءَ
बद्नामूसी	بدناموسي
बद्नाम्	بدنام
बद्नी	بدني
बद्नी	بَدِنيِ
बद्न्यती	بدنيتي
बद्बूइ	بدبوءِ
बद्बूदार	بدبودار
बद्बोइओदार्	بدبوُئِدار
बद्माश	بدمعاش
बद्माश	دشٽ
बद्माशी	بدمعاشي
बद्माश्	بدماش
बद्माश्	بَدماش
बद्मिज़ाज	بدمزاج
बद्मिज़ाज	مزاج
बद्रां	بدران
बद्लाइण	بدلائڻ
बद्लाइणु	بدلائڻ
बद्लाउ	بدلاءُ
बद्ली	بدلي
बद्लो	بدلو
बद्शिकिल	بدشڪل
बद्सूरत	بدسورت
बद्सूरत	بدصورت
बद्सूर्ती	بدصورتي
बद्स्वण	بدسوڻ
बनाम	بنام
बनावट	بناوٽ
बनावटी	بناوٽي
बनावत	بناوت
बनावत	بَناوَت
बनावती	بناوتي
बनावत्	بناوت
बनु	بن
बन्दु	بند
बन्दूक	بندوق
बन्दोबस्त	بندوبست
बन्दोबस्तु	بندوبست
बयाणु	بيان
बयान	بيان
बयान	بَيان
बयानी	بياني
बयानु	بيان
बयान्	بيان
बयाबानु	بيابان
बयाबान्	بيابان
बराबर	برابر
बराबर	برابَر
बराबरी	برابري
बराबरी	بَرابَريِ
बराबर्	برابر
बर्कत	برڪت
बर्ख	برک
बर्ख	ڀرک
बर्ख़ास्तिगी	برخاصتگي
बर्ख़िलाफ़	برخلاف
बर्ख़िलाफ़ी	برخلافي
बर्ख़िलाफ़्	برخلاف
बर्ख़्वास्त	برخواست
बर्ख़्वास्ती	برخواستي
बर्ग़्लाइणु	برغلائڻ
बर्छी	برڇي
बर्जुस्तो	برجستو
बर्जुस्तो	بُرجُستو
बर्तन	برتن
बर्दाश्त	برداشت
बर्दाश्ति	برداشت
बर्पा	برپا
बर्पा	بُنِياد
बर्फ़	برف
बर्फ़ानी	برفاني
बर्फ़ी	بَرفيِ
बर्फ़ीलो	برفيلو
बर्बाद	برباد
बर्बादी	بربادي
बर्बादीअ	برباديءَ
बर्बाद्	برباد
बर्सात	برسات
बर्सात	بَرسات
बर्साती	برساتي
बला	بلا
बलात्कार	بلاتڪار
बल्ग़म	بلغم
बल्वो	بلوو
बवासीर	بواسير
बवंडरु	بونڊر
बवंडरु	ڀونڊر
बशर्तेक	بشرطيڪ
बस	بَسِ
बसर	بصر
बसि	بس
बस्ती	بستي
बस्ती	بَستيِ
बहर	بحر
बहस	بحس
बहसु	بحس
बहादुर	بھادر
बहादुर	بهادر
बहादुरी	بھادري
बहादुरी	بهادري
बहादुरीअ	بهادريءَ
बहादुर्	بھادر
बहाने	بهاني
बहानेबाज़	بهانيباز
बहानो	بھانو
बहानो	بهانو
बहानो	بَهانو
बहार्	بھار
बहाल	بحال
बहाली	بحالي
बहितरी	بهتري
बहितर्	بھتر
बहिरे	بحري
बहिश्कार	بهَشِڪار
बहिस	بحث
बहिसु	بحث
बहिस्	بحث
बहुरूप्दर्शी	بھوروپدرشي
बह्तर्	بھتر
बह्त्रीन	بھترين
बाइज़त्	باعزت
बाकाइएदे	باقائدي
बाकाइदे	باقاعدي
बाकाइदे	باقائدي
बाकाइद्गी	باقاعدگي
बाकी	باقي
बाकी	باقيِ
बाकीदार्	باقيدار
बाक्	باق
बाक्यात	باَقيات
बाग़	باغ
बाग़ी	باغي
बाग़ीचा	باغيچا
बाग़ु	باغ
बाघी	باغي
बाज़	باز
बाज़	بعض
बाज़ि	باز
बाज़ी	بازي
बाज़ीअ	بازيءَ
बाज़ीगर	بازيگر
बाज़ीगरी	بازيگري
बाज़ीग्री	بازيِگري
बाज़ु	باز
बाज़े	بعضي
बाजो	باجو
बातर्तीब	باترتيب
बादल्	بادل
बादामी	بادامي
बादिशाहत्	بادشاھت
बादी	بادي
बाद्बान	بادبان
बाद्शाह	بادشاه
बाद्शाहत्	بادشاھت
बाद्शाहत्	بادشاهَت
बाद्शाही	بادشاهي
बाद्शाह्	بادشاه
बानी	باني
बाबत	بابت
बाबति	بابت
बाबत्	بابت
बाबे	بابي
बार	بار
बारीक	باريڪ
बारीकी	باريڪي
बारीकीअ	باريڪيءَ
बारीक्बीनी	باريڪبيني
बारु	بار
बारूत	باروت
बारे	باري
बार्	بار
बालिग़्	بالغ
बाल्	بال
बाल्टी	بالٽي
बासणु	باسڻ
बासणु	بسڻ
बासींदड़्	باسيندڙ
बाह	باه
बाहि	باھ
बाहि	باه
बांको	بانڪو
बांदर	باندر
बांदरु	باندر
बांस	بانس
बांसवारो	بانسوارو
बांसी	بانسي
बांसी	بانسيِ
बांसु	بانس
बांस्री	بانسري
बि	ب
बि	بِ
बिखारी	بکاري
बिगाड़णु	بگاڙڻ
बिगाड़णु	بگارڻ
बिगाड़िणु	بگاڙڻ
बिगिड़णु	بگڙڻ
बिगिड़णु	بگاڙڻ
बिगिड़्यल	بگڙيل
बिग्ड़ण	بگڙڻ
बिग्ड़णु	بگڙڻ
बिग्ड़ियल	بگڙيل
बिग्ड़ियल्	بگڙيل
बिग्ड़्यल	بگڙيل
बिघ्ड़्यल	بگڙيل
बिजिली	بجلي
बिज्ली	بجلي
बिज्लीअ	بجليءَ
बिज्लीमाप्	بِجِليِماپ
बिद्ड़ी	بدڙي
बिन	بنِ
बिन	بنا
बिनह	بنه
बिना	بنا
बिना	بِنا
बियान	بيان
बिराद्री	برادري
बिलाशक	بلاشڪ
बिलो	بلو
बिलोर	بلور
बिल्कुल	بلڪل
बिल्कुल	بِلڪُل
बिल्कुल्	بلڪل
बिस्त्रो	بِسِتِرو
बिहारणु	بهارڻ
बिहुश्तु	بِهُشت
बिंद्रो	بندرو
बीठलाई	بيٺلائي
बीठलु	بيٺل
बीनी	بيني
बीमार	بيمار
बीमारी	بيماري
बीमारी	بيِماريِ
बीमारीअ	بيماريءَ
बीमारीअ	بيِماريِءَ
बीमार्	بيمار
बीहक	بيهڪ
बीहणु	بيهڻ
बीह्जणु	بيهجڻ
बीह्जी	بيهجي
बुकी	بڪي
बुख	بک
बुखमरी	بکمري
बुखायल	بکايل
बुखायलु	بُکايل
बुखायल्	بکايل
बुख़ार	بخار
बुख़ारु	بخار
बुख्यो	بکيو
बुछां	بڇان
बुछिड़ाई	بڇڙائي
बुछिड़ो	بڇڙو
बुज़ुर्गु	بزرگ
बुज्को	بجڪو
बुज़्दिल	بزدل
बुज़्दिली	بزدلي
बुज़्दिल्	بزدل
बुणाइतो	بڻائتو
बुतु	بت
बुदी	بدي
बुनियाद	برپا
बुनियाद	بنياد
बुनियादी	بنيادي
बुनियाद्	بنياد
बुन्याद	بنياد
बुन्यादी	بنيادي
बुन्याद्	بنياد
बुराई	برائي
बुरी	بري
बुरुश	برش
बुरो	برو
बुर्को	برقعو
बुर्जु	برج
बुलंदी	بلندي
बुलंदी	بُلَنديِ
बुलंदु	بلند
बुल्बुल	بلبل
बुल्बुला	بلبلا
बुशर्टि	بشرٽ
बुश्कूं	بشڪون
बुहिरो	بهرو
बुंडु	بنڊ
बूइ	بوءِ
बूट	بوٽ
बूटु	بوٽ
बूसो	بوسو
बूंद्	بوند
बे	بي
बेअकुल	بيعقل
बेअकुली	بيعقلي
बेइज़ती	بيعزتي
बेइज़्ती	بيعزتي
बेऐबु	بيعيب
बेकाइदे	باقاعِديِ
बेकाइद्गी	بيقاعدگي
बेकाबू	بيقابو
बेकार	بيڪار
बेकार	بيقار
बेकारी	بيڪاري
बेकार्	بيڪار
बेख़बर	بيخبر
बेख़बरीअ	بيخبريءَ
बेख़बर्दार	بيخبردار
बेख़ब्री	بيخبري
बेख़ब्रीअ	بيخبريءَ
बेख़ियालो	بيخيالو
बेख़ुद	بيخد
बेख़्यालो	بيخيالو
बेगम	بيگم
बेघर	بيگھر
बेचयो	بيچيو
बेचैन	بيچين
बेचैनी	بيچيني
बेचैन्	بيچَين
बेजवाब्दार	بيجوابدار
बेजा	بيجا
बेजाइ	بيجاءِ
बेजान	بيجان
बेजान्	بيجان
बेज़ाब्ते	بيظابتي
बेज़ार	بيزار
बेज़ार्	بيزار
बेजाहिद	بيجاحد
बेजिंस	بيجنس
बेज़े	بيضي
बेज़ो	بيضو
बेजोश	بيجوش
बेज़्वी	بيضوي
बेडपो	بيڊپو
बेडौल	بيڊول
बेडौलो	بيدؤلو
बेडौलो	بيڊولو
बेढनंगो	بيڊنگو
बेढंगो	بيڍنگو
बेढ्~अड़क	بيڌڙڪ
बेतक्लुफ़	بيتقلف
बेतरे	بيتَري
बेतर्तीब	بيترتيب
बेतर्फ़्दार	بيطرفدار
बेतर्फ़्दारी	بيترفداري
बेतर्फ़्दारी	بيطرفداري
बेताज	بيتاج
बेतालुकी	بيتعلقي
बेतालो	بيتالو
बेतुको	بيتڪو
बेदर्द	بيدرد
बेदाग़	بيداغ
बेदाग़्	بيداغ
बेदाणो	بيداڻو
बेदार	بيدار
बेदिली	بيدلي
बेदिलीअ	بيدليءَ
बेदिल्यो	بيدليو
बेदीनो	بيدينو
बेदो	بيدو
बेद्ख़ल	بيدخل
बेनज़ीर्	بينظير
बेपर्वाह	بيپرواه
बेपर्वाही	بيپرواهي
बेपर्वाही	بيپرواھي
बेपहुच	بيپهچ
बेफ़ाइदो	بيفائدو
बेफ़ैस्ले	بيفيصلي
बेबुनियाद	بيبنياد
बेमक्सद	بيمقصد
बेमज़े	بيمزي
बेमज़े	بيمَزي
बेमज़े	مزي
बेमत्लब	بيمطلب
बेमाना	بيمعني
बेमिसाल	بيمثال
बेमिसिल	بيمثل
बेमुरवती	بيمروتي
बेमेल	بيميل
बेमौको	بيموقو
बेरहम	بيرحم
बेरहम	بيرهم
बेरहिमी	بيرحمي
बेरियाई	بيريائي
बेरियाईअ	بيريائيءَ
बेरूह	بيروح
बेरोक	بيروڪ
बेरोज़्गार	بيروزگار
बेरोज़्गारी	بيروزگاري
बेरोज़्गार्	بيروزگار
बेलग़ाम	بيلغام
बेलग़ाम्	بيلغام
बेलिहाज़	بيلحاظ
बेवकूफ़	بيوقوف
बेवकूफ़	بيوَقوُف
बेवकूफ़ी	بيوقوفي
बेवकूफ़्	بيوقوف
बेवक्त	بيوقت
बेवक्ताइतो	بيوقتائتو
बेवक्तो	بيوقتو
बेवफ़ाई	بيوفائي
बेवस	بيوس
बेवसु	بيوس
बेवा	بيوا
बेवाज्बी	بيواجبي
बेवाहो	بيواهو
बेशऊर	بيشعور
बेशक	بيشڪ
बेशरम	بيشرم
बेशर्मी	بِشرمي
बेशानाइतो	بيشانائتو
बेशी	بيشي
बेशुकुर	بيشڪر
बेशुमार	بيشمار
बेसबब	بيسبب
बेसमरो	بيسمرو
बेसम्झ	بيسمجھ
बेसम्झ्	سمجھ
बेसलामत	بيسلامت
बेसवाद्	بيسواد
बेसवाद्	سَواد
बेसहारे	بيسھاري
बेसाङाहो	بيساڱاهو
बेसुधी	بيسوڌي
बेहद	بيحد
बेहदि	بيحد
बेहद्	بيحد
बेहयाई	بيهيئي
बेहिमथ	بيھمت
बेहिसाब	بيحساب
बेहूदो	بيهودو
बेहूदो	بيھودو
बेहूदो	بيھوُدو
बेहोश	بيهوش
बेहोशी	بيهوشي
बेह्तर	بهتر
बैट	بيٽ
बैठक	بيٺَڪَ
बैठक	بيٺڪ
बैठ्क	بَيٺڪ
बैतु	بيت
बैद	بعد
बैरो	بئرو
बैलु	بَيل
बोइ	بوءِ
बोजो	بوجو
बोतो	بوتو
बोराओ	بورائو
बोहीचणो	بوهيچڻو
बंद	بند
बंद	بَند
बंद	بَندِ
बंदगी	بندگي
बंदरु	بندر
बंदर्गाह	بندرگاه
बंदर्गाह्	بندرگاه
बंदश	بندش
बंदश्	بندش
बंदि	بند
बंदिश	بندش
बंदिश्	بندش
बंदी	بندي
बंदीघर्	بنديگھر
बंदु	بند
बंदु	بَندُ
बंदूक	بندوڪ
बंदूक	بندوق
बंदूक्ची	بندوقچي
बंदूक्बाज़ी	بندوقبازي
बंदोबस्त	بندوبست
बंदोबस्तु	بندوبست
बंदोबस्त्	بندوبست
बंद्	بند
ब्रहम	برم
ब्रहम्ग्यान	برمگيان
ब्रहम्ग्यानी	برمگياني
ब्रहम्चारी	برھمچاري
ब्रहम्विद्यावादी	برمودياوادي
ब्रह्मांडु	برهمانڊ
ब्राद्री	برادري
ब्राद्रीअ	برادريءَ
ब्राबर	برابر
ॿ	ٻ
ॿ	ٻَ
ॿ	ٻہ
ॿई	ٻَئي
ॿको	ٻڪو
ॿक्री	ٻڪري
ॿक्र्यूं	ٻڪريون
ॿघु	ٻگھ
ॿचा	ٻچا
ॿचो	ٻچو
ॿटाक	ٻٽاڪ
ॿटाकी	ٻٽاڪي
ॿटुओं	ٻٽُئون
ॿटूं	ٻٽون
ॿदलु	ٻدل
ॿधणु	ٻَڌَڻُ
ॿधणु	ٻڌڻ
ॿधल	ٻَڌَلُ
ॿधलु	ٻڌل
ॿधल्	ٻڌل
ॿधाइणु	ٻڌائڻ
ॿधाणी	ٻڌائڻ
ॿधी	ٻَڌيِ
ॿधी	ٻڌي
ॿधो	ٻڌو
ॿधंदड़्	ٻَڌَندَڙ
ॿधंदड़्	ٻَڌَنِدَڙُ
ॿधंदर्	ٻڌندر
ॿनी	ٻني
ॿनो	ٻَنو
ॿॿुलो	ٻَٻُلو
ॿयूं	ٻيون
ॿयो	ٻيو
ॿर	ٻَر
ॿरणु	ٻرڻ
ॿरंदड़	ٻرندڙ
ॿरंदड़ु	ٻرندڙ
ॿरंदड़्	ٻرندڙ
ॿलिदान	ٻلدان
ॿली	ٻلي
ॿलु	ٻل
ॿलु	ٻَلُ
ॿल्वान	ٻلوان
ॿल्वान	ٻَلوانُ
ॿहिकणु	ٻهڪڻ
ॿह्कणु	ٻهڪڻ
ॿह्राड़ी	ٻهراڙي
ॿह्राड़ीअ	ٻهراڙيءَ
ॿाकारणु	ٻاڪارڻ
ॿाच	ٻاچ
ॿाच्को	ٻاچڪو
ॿाझ	ٻاجھ
ॿाझारो	ٻاجھارو
ॿाझ्री	ٻاجھري
ॿाताइणु	ٻاتائڻ
ॿादी	ٻادي
ॿान्हो	ٻانهو
ॿाफ	ٻاڦ
ॿाफ	ٻاف
ॿार	ٻار
ॿारण	ٻارڻ
ॿारणु	ٻارڻ
ॿारन	ٻارن
ॿारहं	ٻارهان
ॿाराणो	ٻاراڻو
ॿारी	ٻاري
ॿारु	ٻار
ॿार्ड़ो	ٻارڙو
ॿार्हां	ٻارهان
ॿाल	ٻال
ॿालक्	ٻالڪ
ॿालक्पणु	ٻالڪپڻ
ॿालक्पण्`	ٻالَڪِپَڻ
ॿालक्पिणो	ٻالڪپڻ
ॿालो	ٻالو
ॿाहिर	ٻاھِرِ
ॿाहिर	ٻاهر
ॿाहिर	ٻاهِر
ॿाहिरां	ٻاھران
ॿाहिरां	ٻاهِران
ॿाहिरां	ٻهران
ॿाहिरियों	ٻاهريون
ॿाहिर्	ٻاھر
ॿाहिर्	ٻاهر
ॿाहिर्यों	ٻاهرون
ॿाहिर्यों	ٻاهريون
ॿाहिर्यों	ٻاهِريون
ॿांहप	ٻانهپ
ॿांहु	ٻانھ
ॿि	ٻِ
ॿिए	ٻي
ॿिए	ٻئي
ॿिए	ٻِئي
ॿिकी	ٻڪي
ॿिचाप्ड़ाई	ٻچاپڙائي
ॿिचाप्ड़ो	ٻچاپڙو
ॿिचितो	ٻچتو
ॿिचित्यो	ٻچتيو
ॿिज	ٻج
ॿिजु	ٻج
ॿिजु	ٻِجُ
ॿिटो	ٻٽو
ॿिति	ٻٽ
ॿिन	ٻن
ॿिनि	ٻِنِ
ॿिपह्री	ٻپهري
ॿिय	ٻيا
ॿियन	ٻين
ॿियो	ٻيو
ॿिरांघ	ٻرانگھ
ॿिरु	بير
ॿिली	ٻلي
ॿिलो	ٻلو
ॿी	ٻي
ॿी	ٻيِ
ॿीअ	ٻيءَ
ॿीड़ो	ٻِيڙو
ॿीणो	ٻيڻو
ॿीहर्	ٻيھر
ॿुझी	ٻجھي
ॿुटो	ٻٽو
ॿुड़ी	ٻڙي
ॿुॾणु	ٻڏڻ
ॿुॾल	ٻڏل
ॿुॾलु	ٻڏل
ॿुॾल्	ٻڏل
ॿुॾी	ٻڏي
ॿुॾंदड़	ٻڏندڙ
ॿुध	ٻڌ
ॿुधण	ٻڌڻ
ॿुधणु	ٻڌڻ
ॿुधरु	ٻڌر
ॿुधल	ٻڌل
ॿुधाइण	ٻڌائڻ
ॿुधाइणु	ٻُڌائِڻُ
ॿुधाइणु	ٻڌائڻ
ॿुधाइं~उ	ٻڌائڻ
ॿुधाईंदड़	ٻڌائيندڙ
ॿुधी	ٻڌي
ॿुधीमान्	ٻڌيمان
ॿुधु	ٻُڌُ
ॿुधू	ٻڌو
ॿुधो	ٻڌو
ॿुध्वारु	ٻڌوار
ॿुसो	ٻسو
ॿुहारणु	ٻهارڻ
ॿुहारी	ٻھاري
ॿुहारी	ٻهاري
ॿुंभो	ٻنڀو
ॿूचु	ٻوچ
ॿूचु	ٻوُچ
ॿूच्	ٻوچ
ॿूझ्	ٻوُجھ
ॿूटन	ٻوٽن
ॿूटी	ٻوٽي
ॿूटो	ٻوٽو
ॿूसाटणु	ٻوساٽڻ
ॿूसाटणु	ٻوساٽجڻ
ॿूंध्री	ٻوُنڏِريِ
ॿेटु	ٻيٽ
ॿेड़ी	ٻيڙي
ॿेड़ीअ	ٻيڙيء
ॿेड़्युन	ٻيڙين
ॿेरु	ٻير
ॿेलाई	ٻيلائي
ॿेले	ٻيلي
ॿेलो	ٻيلو
ॿोझ्	ٻوجه
ॿोड़णु	ٻوڙڻ
ॿोड़ो	ٻوڙو
ॿोॾ	ٻوڏ
ॿोॾि	ٻوڏ
ॿोध	ٻوڌ
ॿोरणु	ٻورڻ
ॿोलणु	ٻولڻ
ॿोलियूं	ٻوليون
ॿोलिह	ٻوله
ॿोली	ٻولي
ॿोलीअ	ٻوليِءَ
ॿोल्ह	ٻولھ
ॿोल्हि	ٻوله
ॿोल्ह्	ٻولھ
ॿोल्ह्	ٻوله
ॿंधन्	ٻنڌن
भॻ	ڀَڳَ
भॻत	آ
भॻती	ڀڳتي
भॻतु	ڀڳت
भॻत्	ڀڳت
भॻदड़	ڀڳدڙ
भॻल	ڀڳل
भॻल्	ڀڳل
भॻवान	ڀڳوان
भॼ	ڀڄ
भॼणु	ڀَڄَڻُ
भॼणु	ڀڄڻ
भॼन	ڀجن
भॼनु	ڀڄن
भॼाइणु	ڀڄائڻ
भॼाए	ڀڄائي
भॼी	ڀَڄيِ
भॼी	ڀڄي
भॼंदड़	ڀڄندڙ
भॼंदड़्	ڀڄندڙ
भञ	ڀڄ
भञकड़ी	بڃڪڙي
भञकड़ी	ڀڃڪڙي
भञणु	ڀڃڻ
भञाइणु	ڀڄائڻ
भञु	ڀَڃُ
भञंदड़	ڀڃندڙ
भञ्कड़ी	ڀڃڪڙي
भड़	ڀڙ
भड़क	ڀڙڪ
भड़ाको	ڀڙاڪو
भड़ु	ڀڙ
भड़्कणु	ڀڙڪڻ
भड़्काइणु	ڀڙڪائڻ
भड़्काइणु	ڀڙڪائڻُ
भड़्काईंदड़	ڀڙڪائيندڙ
भड़्काईंदड़्	ڀڙڪائيندڙ
भड़्कीलो	ڀڙڪيلو
भड़्क्यल	ڀڙڪيل
भतो	ڀتو
भतो	ڀَتو
भदो	ڀدو
भपणु	ڀاپڻ
भभ्के	ڀڀڪي
भभ्केदार	ڀڀڪيدار
भभ्केदार्	ڀڀڪيدار
भयानक	ڀيانڪ
भयानकु	ڀيانڪ
भयानक्	ڀيانڪ
भयंकर्	ڀينڪر
भर	ڀَر
भरण	ڀرڻ
भरणु	ڀرڻ
भरमी	ڀرمي
भरमु	ڀرم
भराइणु	ڀرائڻ
भराई	ڀرائي
भराई	ڀَرائي
भराई	هِمٿَ
भरि	ڀر
भरियलु	ڀريل
भरियल्	ڀريل
भरियो	ڀريو
भरी	ڀري
भरींदड़	ڀريندڙ
भरू	ڀرو
भरे	ڀري
भरो	ڀرو
भरोसे	ڀروسي
भर्कम्	ڀرڪم
भर्जणु	ڀرجڻ
भर्जणु	ڀَرجَڻُ
भर्ती	ڀرتي
भर्ती	ڀَرتي
भर्तु	ڀَرتُ
भर्पूर	ڀرپور
भर्पूर्	ڀرپور
भर्पूर्	ڀَرپور
भर्यल	ڀريل
भर्यलु	ڀريل
भर्यल्	ڀريل
भर्यल्	ڀَريل
भर्यो	پريو
भर्यो	ڀريو
भर्यो	ڀَريو
भर्वसे	ڀروسي
भर्वसे	ڀَرِوَسي
भर्वसो	ڀروسو
भर्वसो	ڀَرِوَسو
भर्वारो	ڀروارو
भर्सां	ڀرسان
भलाई	ڀلائي
भलो	ڀلو
भवन	ڀون
भवाइतो	ڀوائتو
भविश्य	ڀوشي
भविश्यवाणी	واڻي
भसम	ڀسم
भाइटी	ڀائٽي
भाइट्यो	ڀائٽيو
भाइपी	ڀائپي
भाइपीअ	ڀائپي
भाई	ڀائي
भाईचारो	ڀائيچارو
भाईवार	ڀائيوار
भाईवारी	پائيواري
भाउ	ڀاءُ
भाउरन	ڀائرن
भाकुर	ڀاڪر
भाकुर	ڀاڪُر
भाॻ	ڀاڳ
भाॻन	ڀاڳن
भाॻु	ڀاڳ
भाङो	ڀاڱو
भाॼी	ڀاڄي
भाड़णु	ڀاڙڻ
भाड़े	ڀاڙي
भाड़ो	ڀاڙو
भाणु	ڀاڻ
भाणेजी	ڀاڻيجي
भाणेजो	ڀاڻيجو
भाती	ڀاتي
भारी	ڀاري
भालो	ڀالو
भाव	ڀاو
भाव	ڀاوَ
भावनाहीन	ڀاوناهين
भावु	ڀاو
भावुक	ڀاوڪ
भावुक्ता	ڀاوڪتا
भाव्ना	ڀاونا
भाव्नात्मक्ता	ڀاوناتمڪتا
भाशण	ڀاشڻ
भाशण्	ڀاشڻ
भाशा	ڀاشا
भास	ڀاس
भांडो	ڀانڊو
भांत	ڀانت
भिक्शक	ڀڪشڪ
भिख्शू	ڀڪشو
भिॼणु	ڀڄڻ
भिॼाइणु	ڀڄائڻ
भिटिकण	ڀٽڪڻ
भिटिकणु	ڀٽڪڻ
भिट्कणु	ڀٽڪڻ
भिति	ڀت
भिति	ڀِتِ
भिरिश्त	ڀرشت
भिरूं	ڀرون
भिरूं	ڀِرُون
भीड़	ڀيڙ
भीड़ु	ڀيڙ
भुञणु	ڀڃڻ
भुॾो	ڀُڏو
भुण	بڻ
भुण्कणु	ڀڻڪڻ
भुण्भुण	ڀڻءڻ
भुरणु	ڀرڻ
भुरंदड़्	ڀُرَندَڙ
भुल	چُڪَ
भुल	ڀل
भुलणु	ڀلڻ
भुलाईंदड़ु	ڀلائيندڙ
भुलियल	ڀليل
भुल्जणु	ڀلجڻ
भूत	ڀوت
भूतु	ڀوت
भूत्	ڀوت
भूमिका	ڀومڪا
भूमी	ڀومي
भूविग्यान्	ڀووگيان
भूविद्या	ڀووديا
भूसो	ڀوسو
भूं	ڀوُن
भूंगी	ڀونگي
भेट	ڀيٽ
भेटा	ڀيٽا
भेण	ڀيڻ
भेद	ڀيد
भेदु	بيد
भेदु	ڀيد
भेनरुन	ڀينرن
भेरा	ڀيرا
भेरो	ڀيرو
भोॻ	ڀوڳ
भोॻणु	ڀوڳڻ
भोजनालय	ڀوجنالي
भोॼन	ڀوڄن
भोॼनु	ڀوڄن
भोड़्	ٻوڙ
भोरिड़ाई	ڀورڙائي
भोरिड़ो	ڀورڙو
भोलो	ڀولو
भौ	ڀوُ
भौतिक	ڀوتڪ
भौतिक	ڀَوتڪ
भौतिक्वाद	ڀَوتڪواد
भौंकण	ڀوُنڪڻ
भंगी	ڀنگي
भंगु	ڀنگ
भंगुर	ڀنگر
भंडारु	ڀنڊار
भंडारो	ڀنڊارو
भंभट	ڀنڀٽ
भंभ्लाइणु	ڀنڀلائڻ
भंवरु	ڀنور
भ्~अर्माईंदड़्	ڀرَمائيِندَڙ
भ्~अर्यो	ڀريو
भ्यानक	ڀيانڪ
भ्यंकर	ڀينڪر
भ्रमु	ڀرم
भ्रश्ट	ڀرشٽ
भ्रश्टाचार	ڀرشٽاچار
भ्रश्ट्	ڀرشٽ
भ्रश्ट्ता	ڀرشٽتا
मकड़्	مڪڙ
मकाई	مَڪائيِ
मकाई	مڪائي
मकान	مڪان
मकानी	مڪاني
मकानु	مڪان
मकान्	مڪان
मकार	مڪار
मकार्	مڪار
मक्ड़ी	مڪڙي
मक्बरो	مقبررو
मक्ब्रो	مقبرو
मक्सद	مقصد
मक्सद्	مقصد
मखणु	مکڻ
मखि	مک
मख़्सूस	مخصوص
मग़ज़ु	مَعَز
मगन	مگن
मग़िर्बी	مغربي
मग़िर्बु	مغرب
मग़्ज़ी	مغزي
मग़्रूर	مغرور
मग़्रूरी	مغروري
मग़्रूर्	مغرور
मङेतो	مڱيتو
मङ्जणु	مَڱِجَڻُ
मङ्णो	منڳڻو
मङ्णो	مَڱڻو
मङ्यल	مَڱيَل
मङ्यल्	مڱيل
मचणु	مچڻ
मचाइणु	مچائڻ
मछरु	مڇر
मछी	مڇي
मछीअ	مڇيءَ
मज़हब	مذهب
मज़हबी	مذهبي
मज़ह्बी	مذهبي
मज़ाक	مذاڪ
मज़ाकी	مَذاقيِ
मज़ाक्	مذاق
मजिलस्	مجلس
मजिलिस्	مجلس
मज़ूर	مزور
मज़ूर	مضور
मज़ूरी	مضوري
मज़ूरु	مزور
मज़ूर्	مزور
मज़े	مزي
मज़ेदार	مازيدار
मज़ेदार	مزيدار
मज़ेदार्	مزيدار
मज़ो	مزو
मज़्बूत	مضبوت
मज़्बूत	مضبوط
मज़्बूत	مظبوت
मज़्बूती	مضبوت
मज़्बूती	مضبوطي
मज़्बूतीअ	مضبوتيءَ
मज्बूर	مجبور
मज़्मून	مَضِموُن
मज़्मूनु	مضمون
मज़्मून्	مَضمُون
मज्लस	مجلس
मज्लस्	مجلس
मज़्हबी	مذهبي
मज़्हबी	مَّذهَبيِ
मॼाणु	مڄاڻ
मञण	مڃڻ
मञणु	مڃڻ
मञाइण	مَڃائِڻَ
मञाइणु	مڃائڻ
मञिता	مَڃِتا
मञींदड़	مڃندڙ
मञींदड़	مڃيندڙ
मञींदड़ु	مَڃيِندَڙ
मञ्णु	مڃڻ
मञ्ता	مڃتا
मटा	مَٽا
मटाइणु	مٽائڻ
मटिजण	مٽجڻ
मटिजणु	مٽجڻ
मटोल	مٽول
मट्जन्दड़्	مٽجندڙ
मट्सट	مٽسٽ
मठ	مٺ
मठ्यों	مٿيون
मठ्वासी	مٺواسي
मड़्दान्गी	مڙدانگي
मड़्हणु	مڙھڻ
मढुर्ता	مڌرتا
मणी	مڻي
मणु	مڻ
मण्को	مڻڪو
मतां	متان
मतु	مت
मतो	مَتو
मत्भेद्	متبيد
मत्भेद्	متڀيد
मत्लब	مطلب
मत्लब	مَطِلَب
मत्लबी	مطلبي
मत्लबु	مطلب
मत्वालाई	متوالي
मथ	مٿ
मथाछिरो	مٿاڇرو
मथाहीं	مٿاهين
मथाहीं	مٿاھين
मथाहूं	مٿاھون
मथां	مٿان
मथीं	مٿين
मथु	مٿ
मथे	مٿي
मथे	مٿَي
मथो	مٿو
मथ्यों	مٿيون
मदद	مدد
मददगार	مددگار
मददी	مددي
मदद्	مدد
मदद्गार	مددگار
मदद्गार्	مددگار
मदार	مدار
मदार्	مدار
मद्होशी	مدهوشي
मद्होशी	مدھوشي
मधुर	مڌر
मधूशाला	مڌوشالا
मन	ڪٿا
मन	من
मनमौजी	منموجي
मनह	منع
मनहूस	منحوس
मना	منع
मनाइतो	مانائِتو
मनी	مني
मनु	من
मनु	مَنُ
मनोरंजन	منورنجن
मनोहर्	منوھر
मन्ज़िल	مَنزِل
मन्ज़िल	منظل
मन्ज़िल्	مَنزِل
मन्ज़ूर	منظور
मन्ज़ूरी	منظور
मन्ज़ूरी	منظوري
मन्शा	منشا
मन्सूख़	منسوخ
मन्सूबो	منصوبو
मन्हूस्	بي
मबादा	مباد
मम्किन्	مَمڪِن
मयादते	ميادتي
मयादु	مياد
मयाद्	مياد
मयारु	معيار
मरण	مارڻ
मरण	مرڻ
मरणु	مرڻ
मरणु	مرڻُ
मरह्बा	مرهبا
मरामत	مرامت
मरी	مري
मरीज़	مريض
मरु	مر
मरोड़	مروڙ
मरोड़णु	مروڙڻ
मरोड़्यलु	مروڙيل
मर्कज़	مرڪز
मर्कज़	مَرڪَز
मर्ज़ी	مرضي
मर्ज़ीअ	مرضيءَ
मर्ज़ु	مرض
मर्तबो	مرتبو
मर्दानो	مردانو
मर्दांगी	مردانگي
मर्दु	مرد
मर्मत	مرمت
मर्यादा	مريادا
मर्हबा	مرحبا
मर्हूम्	مرحوم
मल	ملم
मलणु	ملڻ
मलम	ملم
मलम	مَلَم
मलम्उ	ملم
मलाई	ملائي
मलामत	ملامت
मलाह	ملاح
मलाहु	ملاح
मलाह्	ملاه
मलीका	مليِڪا
मलीका	مَليِڪا
मलूक्	ملوڪ
मलो	ملو
मल्बो	ملبو
मल्मल	ململ
मल्लाहु	ملاح
मल्ह	مله
मल्हाइणु	ملھائڻ
मल्हाइणु	مَلِھائِڻُ
मल्हाइणु	ملهائڻ
मवाद	مواد
मवादी	موادي
मशहूर	مشهور
मशहूर	مشھور
मशहूरी	مشهوري
मशहूरी	مشهوريِ
मशहूर्	مشھور
मशहूर्	مشھوُر
मशीन	مشين
मशीन्	مشين
मश्ग़ूल	مشغول
मश्ग़ूली	مشغولي
मश्ग़ूली	مَشغولي
मश्रक	مشرق
मश्रकी	مَشرَقي
मश्हूर	مشهور
मश्हूरी	مشهوري
मस	مس
मसमस	مسمس
मसाणो	مساڻو
मसालेदार	مصاليدار
मसालो	مسالو
मसालो	مصالو
मसीत	مسيت
मसु	مس
मसूदो	مسودو
मसूर	مسور
मसैलो	مسئلو
मस्ख़री	مسخري
मस्ख़रो	مسخرو
मस्ख़िरो	مسخرو
मस्ख़िरो	مَسِخِرو
मस्ख़्री	مسخري
मस्ख़्रो	مسخرو
मस्जिद	مسجد
मस्तानो	مستانو
मस्ती	مستي
मस्वाड़ी	مسواڙي
महत्व	مھتوَ
महत्वपूर्ण	مهتوپورڻ
महमिल	مهمل
महर्बान	مهربان
महर्बानी	مھرباني
महर्बानी	مهرباني
महर्बाने	مهرباني
महल	محل
महा	مها
महात्मा	مهاتما
महान	مھان
महान	مهان
महानगर	مهانگر
महाराणी	مَھاراڻي
महांगाई	مھانگائي
महांगो	مھانگو
महिटणु	مهٽڻ
महिणेख़ोर	مهڻيخور
महिणो	مهڻو
महिनत	محنت
महिनत्	محنت
महिनाइतो	محنائتو
महिने	مهني
महिनो	مهنو
महिन्ताणो	مهنتاڻو
महिन्ती	محنتي
महिफ़िल्	محفل
महिमा	مهما
महिरूम्	محروم
महिर्बानी	مهرباني
महिर्बान्	مھربان
महिल	مهل
महिलाइतो	مهلائتو
महीनो	مھينو
महुताज्	محتاج
महूरत	مهورت
महंदार्	مھندار
मह्णो	مهڻو
मह्नो	مهنو
मह्फ़िल	مهفل
मह्फ़ूज़	محفوز
मह्फ़ूज़	محفوظ
मह्फ़ूज़्गी	محفوظگي
मह्मा	مھما
मह्मान	مھمان
मह्मान	مهمان
मह्मानु	مهمان
मह्रूम	محروم
मह्रूम	مَحِروُم
मह्रूमी	محرومي
मह्र्बान्	مھربان
मह्लात	محلات
मह्वूज़	محفوظ
मह्सूल	محصول
मह्सूलु	محسول
मह्सूलु	محصول
मह्सूस	محسوس
मह्सूस	مهسوس
माइट	مائٽ
माइटाणो	مائٽاڻو
माइटी	مائٽي
माइटु	مائٽ
माइल	مائل
माइल्	مائل
माउ	ماءُ
माक	ماڪ
माकड़ि	ماڪڙ
माकोड़ी	ماڪوڙي
माखी	ماکي
माखीअ	ماکيء
माचीस	ماچيس
माज़ी	ماضي
माटेजो	ماٽيجو
माठ	ماٺ
माठि	ماٺ
माठीणो	ماٺيڻو
माठो	ماٺو
माड़ि	ماڙ
माडुऊल	ماڊيول
माड़ो	ماڙو
माणणु	ماڻَڻُ
माणिक	ماڻڪ
माण्हुन	ماڻهن
माण्हू	ماڻهو
माण्हू	ماڻھو
मात	مات
मातम	ماتم
मातमी	ماتمي
मातहितु	ماتھت
माता	ماتا
माति	مات
मातिर	ماتر
मात्पिणो	ماتپڻو
मात्र	ماتر
मात्रा	ماترا
मात्हती	ماتهتي
माथिरी	ماٺري
मादा	مادا
मादो	مادو
मादो	معدو
माद्री	مادري
माध्यमिक	ماڌيمڪ
मान	معني
मान	معنى
मानवारो	مانوارو
माना	معني
मानाइतो	مانائتو
मानारो	مانارو
मानी	ماني
मानीअ	مانيء
मानु	مان
मानु	مانُ
मानो	معنو
मान्वारो	مانوارو
मान्सिक	مانسڪ
माप	ماپ
माप	ماپَ
मापक	ماپڪ
मापण	ماپڻ
मापणु	ماپڻ
मापो	ماپو
माफ़	معاف
माफ़ी	معافي
माफ़ीअ	معافيءَ
मामिलो	معاملو
मामी	مامي
मामूली	معامولي
मामूली	معمولي
मामो	مامو
माम्लो	معاملو
माया	مايا
मायूस	مايوس
मायूसी	مايوسي
मायूस्	مايوس
मार	مار
मार	مارَ
मारणु	مارڻ
मारामारी	ماراماري
मारी	ماري
मारींदाड़	ماريندڙ
मारे	ماري
मारोट्	ماروٽ
मार्को	مارڪو
मार्गु	مارگ
मार्च	مارچ
मार्फ़त	معرفت
मार्फ़ति	معرفت
मार्यल	ماريل
मार्यलु	ماريل
माल	مال
माल	مالَ
माला	مالا
मालिक	مالڪ
मालिकाणो	مالڪاڻو
मालिकी	مالڪي
मालिकीअ	مالڪيءَ
मालिकु	مالڪ
मालिक्	مالڪ
मालिश	مالش
माली	مالي
मालीख़ूलिआ	ماليخوليا
मालु	مال
मालूम	معالوم
मालूम	معلوم
माल्	مال
माल्काणो	مالڪاڻو
माल्किण	مالڪڻ
माल्क्याणी	مالڪياڻي
माल्हा	مالها
मासात्	ماسات
मासिक	ماسڪ
मासी	ماسي
मासु	ماس
मासूम	معاسوم
मासूम्	معصوم
मासूम्यत्	معصوميت
मास्तरु	ماستر
मास्तेयाणी	ماسترياڻي
माहिर	ماھر
माहिर	ماهر
माहिरु	ماهر
माहिर्	ماهِر
माहोल	ماحول
माह्वार	ماهوار
मां	۾
मां	مان
मांझी	مانگھي
मांदाई	ماندائي
मांदो	ماندو
मांहू	ماڻهو
मिक्दारु	مقدار
मिच्काइणु	مچڪڻ
मिज़ाज	مزاج
मिज़ाजी	مزاجي
मिज़ाजु	مزاج
मिज़ाज्	مزاج
मिट	مٽ
मिटाइणु	مِٽائِڻُ
मिटाइणु	مٽائڻ
मिटी	مٽي
मिटीअ	مِٽيِءَ
मिठ	مٺ
मिठाई	مٺائي
मिठी	مٺي
मिठू	مٺوُ
मिठेरो	مٺيرو
मिठो	مٺو
मितेरो	متيرو
मित्रता	مترتا
मिथुन	مٿن
मिथ्या	مِٿِيا
मिथ्या	مٿيا
मिनारो	منارو
मिन्टु	منٽ
मिन्थ	ڪَرَڻُ
मिन्थ	منٿ
मिन्थ	مِنٿ
मिन्थूं	منٿون
मियाणु	مياڻ
मिरूं	مرون
मिर्गी	مرگي
मिर्घी	مِرگھِي
मिर्च	مرچ
मिर्चु	مرچ
मिर्त्यू	مرتيو
मिल	مل
मिलण	ملڻ
मिलणु	ملڻ
मिलत्	ملت
मिलन	ملن
मिलन्सार	ملنسار
मिलाइणु	ملائڻ
मिलावत	ملِاوَت
मिलावती	مِلاوَتيِ
मिली	ملي
मिली	مِليِ
मिल्कियत्	ملڪيت
मिल्क्यत	ملڪيت
मिल्क्यत	مِلڪيَتَ
मिल्क्यत्	مِلڪيَت
मिल्णो	ملڻو
मिल्णो	مِلڻو
मिल्यल	مليل
मिल्यलु	مليل
मिल्यल्	مليل
मिल्यल्	مِلِيَلَ
मिशन	مشن
मिश्रणु	مشرڻ
मिसाल	مثال
मिसाल	مِثال
मिसालन	مثالن
मिसाली	مثالي
मिसाल्:	مثال:
मिसाल्	مثال
मिसाल्	مِثال
मिसिल	مثل
मिस्कीन	مسڪين
मिस्त्री	مستري
मिस्यल	مسيل
मिस्यल्	مسيل
मिस्सल्:	مثال:
मिंथ	منٿ
मीकणु	ميڪڻ
मीर	مير
मीरास्	ميراث
मींहुं	مينھن
मींहुं	مينهن
मुअज़िज़	معزز
मुअल्	مئل
मुअल्	مُئَلُ
मुक	مڪ
मुकदम	مقدم
मुकदिमो	مقدمو
मुकद्मो	مقدمو
मुकरर	مقرر
मुकररी	مقرري
मुकाबिलो	مقابلو
मुकाब्लो	مقابلو
मुकूं	مڪون
मुक्त	مڪت
मुक्ती	مڪتي
मुक्रर	مقرر
मुक्ररी	مقرري
मुक्रर्	مقرر
मुख	مک
मुख़त्सर	مختصر
मुख़ालिफ़	مخالف
मुख़ालिफ़्	مخالف
मुख़ाल्फ़त	مخالفت
मुखी	مکي
मुखी	مُکي
मुखु	مک
मुखौटो	مکوٽو
मुख़्तलिफ़	مختلف
मुख़्तलिफ़्	مختلف
मुख़्तारी	مختاري
मुख़्तियार	مُختيار
मुख़्त्यार	مختيار
मुख़्त्यारी	مختياري
मुख़्बिर	مخبر
मुख्य	مايَ
मुख्य	مکي
मुख्य	مکيَ
मुख्य	مُکيَ
मुख्य	مُکِيَ
मुख्यता	مکيتا
मुग्ध	مُگڌ
मुछ	مڇ
मुज़कर	مذڪر
मुटणु	مٽڻ
मुटु	مٽ
मुठि	مٺ
मुठु	مٺ
मुड़ण	مڙڻ
मुड़णु	مڙڻ
मुड़ियल	مڙيل
मुड़ंदड़	مڙندڙ
मुड़ंदड़ु	مڙندڙ
मुड़्दो	مڙدو
मुड़्सी	مڙسي
मुॾु	مُڏُ
मुॾो	مُڏو
मुतिर्को	مترڪو
मुदबिर्	مدبر
मुदे	مدي
मुदो	مدو
मुद्गर	مدگر
मुनणु	منڻ
मुनसिब्	مناسب
मुनाज़िरो	مناظرو
मुनारो	منارو
मुनासिब	مناسب
मुनासिब	مُناسِب
मुनासिब	مناصب
मुनासिब्	مناسب
मुन्शी	مُنشيِ
मुफ़ासिलो	مفاصلو
मुफ़ास्लो	مفاصلو
मुफ़ीद	مفيد
मुफ़्ट	مفت
मुफ़्त्	مفت
मुफ़्त्ख़ोर	مفتخور
मुबारक	مبارڪ
मुबार्कूं	مبارڪوُن
मुबाहिसे	مباحثي
मुबाहिसो	مباحثو
मुमिकन	ممڪن
मुम्किन	ممڪن
मुराद	مراد
मुरादो	مرادو
मुराद्	مُرادَ
मुरीद्	مريد
मुर्कणु	مرڪڻ
मुर्घी	مرغي
मुर्झाइणु	مرجھائڻ
मुर्दा	مردا
मुर्दो	مردو
मुर्बी	مُربيِ
मुर्बो	مربو
मुर्ली	مرلي
मुलाकात	ملاقات
मुलाकाती	ملاقاتي
मुलाकात्	ملاقات
मुलायम	ملايم
मुलायमु	ملايم
मुलैठी	مليٺي
मुल्क	ملڪ
मुल्की	ملڪي
मुल्कु	ملڪ
मुल्तवी	ملتوي
मुल्मो	ملمعو
मुल्हबंदी	ملهبندي
मुल्हाइतो	ملهائتو
मुल्हु	ملھ
मुल्हु	ملھُ
मुल्हु	مله
मुवाकिफ़्	مواقف
मुवाफ़िक	موافڪ
मुवाफ़िकत	موافقت
मुशाबिहत्	مشابحت
मुशिक्ल्	مشڪل
मुशीर	مُشيِرُ
मुश्क	مشڪ
मुश्कणु	مشڪڻ
मुश्कल	مشڪل
मुश्किल	مشڪل
मुश्किलाति	معشڪلات
मुश्किलात्	مشڪلات
मुश्किल्	مشڪل
मुश्क्लात्	مشڪلات
मुश्तकु	مشطاق
मुसम	موسم
मुसल्मान	مسلمان
मुसाफ़िर	مسافر
मुसाफ़िरी	مسافري
मुसाफ़िरीअ	مسافريءَ
मुसाफ़िरीअ	مسافريءِ
मुसाफ़िरु	مسافر
मुसाफ़्री	مسافري
मुसाफ़्री	مُسافريِ
मुसीबत	مصيبت
मुसीबत्	مصيبت
मुस्क्राइणु	مسڪرائڻ
मुस्टंडो	مسٽنڊو
मुस्तकबिल्	مستقبل
मुस्तरु	مستر
मुस्लिम	مسلم
मुहबत	محبت
मुहाॻ	مُھاڳُ
मुहाॻु	مھاڳ
मुहाजिरत	مهاجرت
मुहाजिरु	مهاجر
मुहाणो	مهاڻو
मुहार	مُھارَ
मुहावरो	محاورو
मुहाविरो	مھاورو
मुहाविरो	محاورو
मुहांडो	مهانڊو
मुहिबु	محب
मुह्कुमु	مهڪم
मुह्ताज्	محتاج
मुह्बत	محبت
मुह्मली	مهملي
मुह्मिल	مهمل
मुह्या	مهيا
मुह्लत	مهلت
मुंझाइणु	منجھائڻ
मुंझाइणु	مُنجھائِڻُ
मुंझाईंदड़	منجھائيندڙ
मुंझाए	منجھائي
मुंझारो	منجھارو
मुंझियलु	منجھيل
मुंझियल्	مُنجھِيَل
मुंझ्यल	منجھيل
मुंझ्यलु	منجھيل
मुंझ्यलु	مُنجِھيَل
मुंझ्यल्	منجھيل
मुंडी	منڊي
मुंढु	منڍ
मुंढु	منڍُ
मुंढ्	منڍ
मुंतज़िर	منتظر
मुंद	مند
मुंदाइतो	مندائتو
मुंशी	منشي
मुंहान्डी	مُھانڊيِ
मुंहिंजो	منهنجو
मुंहुं	منھن
मुंहुं	منهن
मुंहं	منھن
मुंहं	منهن
मुंहं	مُنهَن
मूजिब	موجب
मूजिब	موُجب
मूजिब्	موجب
मूड़े	موڙي
मूम्याई	موميائي
मूरी	موري
मूर्ख	مورک
मूर्खाई	مورکائي
मूर्खु	مورک
मूर्खु	موُرکُ
मूर्ख्	مورک
मूर्ख्ता	مورکتا
मूर्छ	مورڇا
मूर्छा	مورڇا
मूर्छित	مورڇت
मूर्त	مورت
मूर्ती	مورتي
मूल	مول
मूलु	مول
मूल्	مول
मूहींदड़	موهيندڙ
मूं	مون
मूंझारे	مونجھاري
मूंझारो	مونجھارو
मूंह	منھن
मूंह	مونھن
मेइं	۾
मेख़	ميخ
मेछ	ميڇ
मेज़्बान्	ميزبان
मेटे	ميٽي
मेठाजु	ميٺاج
मेड़णु	ميڙڻ
मेडल	ميڊل
मेड़ु	ميڙ
मेड़ु	ميڙُ
मेड़्यल	ميڙيَل
मेण	ميڻ
मेणु	ميڻ
मेण्तो	ميڻتو
मेथी	ميٿي
मेरो	ميرو
मेल	ميل
मेलाप	ميلاپ
मेलापी	ميلاپي
मेलापु	ميلاپ
मेलु	ميل
मेलो	ميلو
मेवन	ميون
मेवेदार्	ميويدار
मेश	ميش
मेह्तरु	ميهتر
में	۾
में	پاڻ
में	م
में	مء
मेंदी	ميندي
मेंहिं	مينھن
मैट्रिक	ميٽرڪ
मैथुन	مَيٿن
मैदनी	معدني
मैदान	ميدان
मैनेजर	مينيجر
मोकल	موڪل
मोका	موڪا
मोकिलणु	موڪلڻ
मोको	موقعو
मोक्लणु	موڪلڻ
मोक्लणु	موڪلڻُ
मोक्लाइणु	موڪلائڻ
मोक्लाणी	موڪلاڻي
मोक्लिणु	موڪلڻ
मोक्लियल	موڪليل
मोक्लियलु	موڪليل
मोक्लींदड़	موڪليندڙ
मोक्लींदर्	موڪليندڙ
मोक्लूं	ملڪلون
मोक्ल्यल	موڪليل
मोखु	موک
मोग्रो	موگرو
मोॻाई	موڳائي
मोॻो	موڳو
मोॻो	موڳوبي
मोचारो	موچارو
मोची	موچي
मोट	موٽ
मोटणु	موٽڻ
मोटर्	موٽر
मोटाइणु	موٽائڻ
मोटाए	موٽائي
मोटायल	موٽايل
मोटी	موٽي
मोटी	موٽيِ
मोटो	موٽو
मोड़णु	موڙڻ
मोड़ु	موڙ
मोड़्यल्	موڙيل
मोती	موتي
मोत्यो	موتيو
मोम	موم
मोमी	مومي
मोरी	موري
मोरीअ	موريءَ
मोरु	مور
मोर्चा	مورچا
मोर्चाबंदी	مورچابندي
मोर्छा	مورڇا
मोहणु	ڪَرَڻُ
मोहणु	موھڻ
मोहिणी	موهڻي
मोहित	موھت
मोहित	موهڻُ
मोहित	موهِت
मोहित्	موھت
मोहीड़ो	موهيڙو
मोहींदड़	موهيندڙ
मोहींदड़	موھيندڙ
मोहींदड़्	موهيندَڙُ
मोहींदड़्	موھيندڙ
मोंझारो	مونجھارو
मौकूफ़	موقوف
मौज	موج
मौज	مَوج
मौज	مَئوجَ
मौजी	مَوجي
मौजी	مَوجيِ
मौजूद	موجود
मौजूद	موجوده
मौजूद्	موجود
मौजूद्गी	موجودگي
मौज़ूनी	موزوني
मौत	موت
मौत	مَوت
मौत्	موت
मौत्मार	موتمار
मौत्मार्	موتمار
मौत्मार्	مَوتمار
मौन	مون
मौरूसी	مَوروثي
मौसम	موسم
मौसमी	موسمي
मंगल	منگل
मंचु	منچ
मंज़िल्	منزل
मंज़ूर	منظور
मंज़ूरी	منظوري
मंझां	منجھان
मंझि	منجھ
मंझि	منجه
मंझंद	منجھند
मंझंद	مَنجھَند
मंडल	منڊل
मंडल्	مَنڊَل
मंडी	منڊي
मंतर	منتر
मंत्र	منتر
मंत्रालय	منترالي
मंत्री	منتري
मंदिर	مندر
मंदी	مندي
मंदो	مندو
मंसूख़	منسوخ
मंसूख़ी	منسوخي
मंसूबे	منصوبي
मंसूबो	منصوبو
म्रिघ	مرگھ
म्वाफ़िक्यत्	مُوافِقِيَتِ
यकीन	يقين
यकीनन	يَڪيِنَن
यकीनन्	يقينن
यकीन्	يقين
यको	يَڪو
यक्दम	يڪدم
यक्दम	يَڪِدَم
यक्दम्	يڪدم
यक्दम्	يقدم
यक्राइ	يڪراءِ
यक्राई	يڪرائي
यख़्नी	يخني
यगानो	يگانو
यटु	يَٽُ
यतीम	يتيم
यतीम्ख़ानो	يتيمخانو
यत्रीअ	ياتريِءَ
यथार्थ	يٿارٿ
यहूदी	يھودي
यहूद्युनि	يهودين
या	ٿا
या	يآ
या	يا
याकूत	ياقوت
यात्रा	ياترا
यात्रा	يترا
यात्री	ياتري
याद	ياد
यादाश्त	ياداشت
याद्गार	يادگار
याद्गार्	يادگار
याद्गिरीअ	يادگريءَ
याद्गीरी	يادگيري
याद्गीरी	يادِگيِريَ
याद्गीरीअ	يادگيريءَ
याद्गीर्यूं	يادگيريون
यानी	يعني
याने	ياني
याने	يعني
यार	يار
यारहां	يارِھان
यार्हों	يارھون
यांत्रिक	يانترڪ
युधि	يڌ
यूनिट	يونٽ
योग	يوگ
योगी	يوگيِ
योजना	يوجنا
योज्ना	يوجنا
योनी	يوني
यंत्र	ينتر
यंत्रु	ينتر
रईस्	رئيس
रकम	رقم
रकम्	رقم
रकीब	رقيب
रख	رَکَ
रखण	رکڻ
रखणु	رڪڻ
रखणु	ڪرڻ
रखणु	رکڻ
रखणु	رکڻُ
रखणु	رَکَڻُ
रखणु	رَکڻُ
रखण्	رکڻ
रखन्दड़्	رکندڙ
रखिए	رکِئي
रखंडड़्	رکندڙ
रखंदड़	رکندڙ
रखंदड़	رَکَندَڙ
रखंदड़	رَکَندَڙُ
रखंदड़ु	رکندڙ
रखंदड़्	رکندڙ
रखंदड़्	رَکَندَڙ
रख्यक	رکيڪ
रख्यकु	رکيڪ
रख्यल	رکيل
रख्या	رکيا
रङणु	رڱڻ
रचणु	رچڻ
रचींदड़्	رچيندڙ
रच्ना	رچنا
रच्ना	رَچِنا
रज़ाई	رضائي
रज़ामंद	رضامند
रज़ामंदी	رضامندي
रटणु	رٽڻ
रड़णु	رڙڻ
रड़ि	رڙ
रड़ोरड़	رڙورڙ
रड़्यूं	رڙيون
रतन्	رتن
रती	رتي
रतीअ	رتيءَ
रतु	رت
रतौंधी	رتونڌي
रत्	رَت
रद	رد
रद	رَد
रदि	رد
रदी	ردي
रदेअमल	رد-عمل
रधणु	رڌڻ
रध्णो	رڌڻو
रनड़ु	رنڙ
रन्गत	رنگت
रन्गु	رَنگُ
रफ़ू	رفو
रफ़्तार	رفتار
रॿ	رٻ
रॿड़	رٻڙ
रम्ज़	رمز
रम्ज़ी	رمزي
रयाई	ريائي
रवा	روا
रवाज	رواج
रवाजी	رواجي
रवाजी	رَواجيِ
रवाजु	رواج
रवाजु	رواجُ
रवाज्	رواج
रवानो	روانو
रवान्गी	روانگي
रवायत	روايت
रवांगी	روانگي
रसम	رسم
रसम	رَسَمَ
रसमी	رسمي
रसम्	رسم
रसाईंदड़	رسائيندڙ
रसिजणु	رسجڻ
रसी	رسي
रसीद	رسيد
रसु	رس
रसोई	رسوئي
रस्ते	رستي
रस्तो	رستو
रस्यल	رسيل
रहण	رَھَڻَ
रहण	رھڻ
रहण	رهڻ
रहणु	رھڻ
रहणु	رهڻ
रहणु	رَهَڻُ
रहम	رحم
रहम	رهم
रहम्दिल	رحمدل
रहस्य	رهسي
रहस्यवाद	رهسيواد
रहस्यवादी	رهسيوادي
रहाकू	رَھاڪوُ
रहाकू	رھاڪو
रहाकू	رهاڪو
रहाकू	رَهاڪوُ
रहिड़णु	رهڙڻ
रहिबर	رهبر
रहिम	رحم
रहिम्	رحم
रहिंड	رهنڊ
रहिंडणु	رهنڊڻ
रहिंडा	رھنڊا
रहंदड़	رهندڙ
रहंदड़	رَهَندَڙ
रहंदड़्	رھندڙ
रह्ज़नी	رهزني
रह्जी	رھجي
रह्मानी	رحماني
रह्म्दिल	رهمدل
रह्यलु	رهيل
रह्यलु	رَهيَلُ
रह्यो	رهيو
रह्वासी	رهواسي
राइ	راء
राइ	راءِ
राइ	رائ
राई	رائي
राकासी	راڪاسي
राकास्	راڪاس
राक्शस	راڪشس
राखो	راکو
राॻ	راڳ
राॻी	راڳي
राॻींदड़	راڳيندڙ
राॻु	راڳ
राज	راج
राजा	راجا
राजाई	راجائي
राज़ी	راضي
राज़ु	راز
राज़ो	رازو
राज्कुमार	راجڪمار
राज्कुमारी	راجڪماري
राज्तंत्र	راجتنتر
राज़्दारी	رازداري
राज्दूत्	راجدوت
राज्द्रोह्	راجدروه
राज्धानी	راجڌاني
राज्मिस्त्री	راجمستري
राज्सी	راجسي
राॼ	راڄ
राॼगदी	راجگدي
राॼधानी	راڄڌاني
राॼनीतिक	راڄنيتڪ
राॼनीती	راجنيتي
राॼनीती	راڄنيتي
राॼनेता	راڄھنيتا
राॼु	راڄ
राणी	راڻي
राणीअ	راڻيءَ
रात	رات
राति	رات
रान	ران
रानी	راني
रायो	رايو
राशन	راشن
राशी	راشي
रास	راس
राहत	راحت
राही	راهي
रांद	راند
रांदि	راند
रांदीको	رانديڪو
रांदीगर	رانديگر
रिआयत	رعايت
रिआयत	رئايت
रिआयत्	رعايت
रिकेबी	رڪيبي
रिजणु	رجڻ
रिटायर	رٽاير
रिड़्हणु	رڙهڻ
रिढ	رڍ
रिढूं	رِڍوُن
रिणी	رڻي
रिणु	رڻ
रिथ	رٿ
रिथ	رٿا
रिथा	رٿا
रिथिणु	رٿڻ
रिल्णो	رِلڻو
रिशभ	رشڀ
रिशी	رشي
रिश्तेदार	رشتيدار
रिश्तेदारी	رشتيداري
रिश्तेदार्	رشتيدار
रिश्तो	رشتو
रिश्वत	رشوت
रिश्वत्	رِشِوَت
रिसाव्	رساو
रिसेस	رسيس
रिहा	رها
रिहाई	رھائي
रिह्लत	رھلت
रीझणु	ريجھڻ
रीझाइणु	ريجھائڻ
रीझाईंदड़	ريجھائيندڙ
रीड़्हि	ريڙه
रीत	ريت
रीत	ريِت
रीति	ريت
रीत्	ريت
रीम	ريم
रीलु	ريل
रीस	ريس
रीस	رِيسَ
रीसाड़ो	ريساڙو
रीसारो	ريسارو
रींघटु	رينگھٽ
रुअणु	روئڻ
रुअणु	رئڻ
रुअणु	لئڻ
रुक	رڪ
रुकणु	رڪڻ
रुकावट	رڪاوٽ
रुकावट्	رڪاوٽ
रुको	رقعو
रुक्जणु	رڪجڻ
रुक्यल	رڪيَل
रुख	رک
रुख़ु	رخ
रुख़ु	رُخُ
रुखु	رک
रुखे	رکي
रुखो	رکو
रुख़्सत	رخصت
रुॻो	رُڳو
रुॻो	رڳو
रुजुआत	رجوعات
रुजू	رجو
रुञ	رڃ
रुठल	رٺل
रुति	رت
रुतु	رت
रुधल	رُڌَلُ
रुधलु	رڌل
रुधल्	رُڌَلُ
रुबणु	ربڻ
रुमाल्	رومال
रुलणु	رلڻ
रुश्टु	رشٽ
रुश्वत	رشوت
रुश्वत्खोर्	رشوتکور
रुस	رس
रुसिणो	رسڻو
रुस्णो	رسڻو
रूअणु	روٰئڻ
रूअंदर	روئندر
रूप	روپ
रूप	روُپ
रूपांतर	روپانتر
रूपांतरण	روپانترڻ
रूपी	روپي
रूपु	روُپ
रूहानियत	روحانيت
रूहानी	روحاني
रूहान्यत	روحانيت
रूहु	روح
रूह्	روہ
रूंअणु	روُئَڻُ
रे	ري
रेखा	ريکا
रेग्यूलेटर	ريگيوليٽر
रेज़िकी	ريزڪي
रेज़ो	ريزو
रेज्	ريج
रेटे	ريٽي
रेड	ريڊ
रेती	ريتي
रेपोर्ट	رپورٽ
रेफ़्री	ريفري
रेल	ريل
रेल्छेल	ريلڇيل
रेशम	ريشم
रेश्मी	ريشمي
रोअणु	روئڻ
रोक	روڪ
रोक	روڪَ
रोकण	روڪڻ
रोकणु	روڪڻ
रोकींदड़	روڪيندڙ
रोकींदड़ु	روڪيندڙ
रोकु	روڪ
रोके	روڪي
रोक्ड़ा	روڪڙا
रोग़न	روغن
रोग़नु	روغن
रोॻ	روڳ
रोॻी	روڳي
रोॻु	روڳ
रोज़ी	روزي
रोज़्	روز
रोज़्नामो	روزنامو
रोड़ो	روڙو
रोदनु	رودن
रोपणु	روپڻ
रोब	روبَ
रोब्दार	روبدار
रोमन	رومَن
रोमांच	رومنچ
रोमांचित	رومانچت
रोमांस	رومانس
रोलाक	رولاڪ
रोलाकु	رولاڪ
रोलू	رولو
रोश	روش
रोशन	روشن
रोशन	روشَن
रोशन्	روشن
रोशन्	روشني
रोशिनी	روشني
रोश्नी	روشني
रौ	رءُ
रौनक	رونق
रौनक	رَونق
रौंशो	رونشو
रंग	رنگ
रंगत	رنگت
रंगति	رنگٽ
रंगति	رنگت
रंगन	رنگن
रंगभूमी	رنگڀومي
रंगा	رنگا
रंगी	رنگي
रंगीन	رنگين
रंगीन्	رنگين
रंगु	رنگ
रंगो	رنگو
रंग्भूमी	رنگڀومي
रंग्साज़	رنگساز
रंङियल्	رنگيل
रंज	رنج
रंजश्	رنجش
रंजाइणु	رنجائڻ
रंजायल्	رنجايل
रंजि	رنج
रंजिश	رنجش
रंजु	رنج
रंज्	رنج
रंडक	رنڊَڪ
रंडक	رنڊڪ
रंडक्	رنڊڪ
रंडी	رنڊي
रंदो	رندو
रंभणु	رنڀڻ
लई	لئي
लकबु	لقب
लकब्	لقب
लकुणु	لڪڻ
लक्ड़ी	لڪڙي
लख	لک
लखु	لک
लगन	لگن
लगन्	لگن
लगाइणु	لڳائڻ
लग़ाम	لغام
लग़ाम	لَغام
लॻ	لَڳ
लॻ	لڳ
लॻण	لڳڻ
लॻणु	لڳڻ
लॻणु	لڳل
लॻभॻ	لڳڀڳ
लॻभङ	لڳڀڳ
लॻलु	لڳڻ
लॻाइण	لڳائڻ
लॻाइणु	لَڳائِڻ
लॻाइणु	لَڳائِڻُ
लॻाइणु	لڳائڻ
लॻाइणु	يا
लॻाउ	لڳاءُ
लॻातार	لَڳاتار
लॻातार	لڳاتار
लॻातार्	لڳاتار
लॻो	لَڳو
लॻो	لڳو
लॻोलॻ	لڳولڳ
लचक	لچڪ
लचक्दार्	لچڪدار
लछण	کڇڻ
लछण	لڇڻ
लछेदार	لڇيدار
लछ्मी	لڇمي
लज़ीज़	لذيذ
लज़ीज़	لظيظ
लज़ीज़ु	لذيذ
लज़ीज़्	لذيذ
लॼ	لڄ
लॼाइतो	لڄائتو
लॼारो	لڄارو
लॼी	لڄي
लट	لٽ
लटिकणो	لٽڪڻو
लटिकाइणु	لٽڪائڻ
लटिकंडड़	لٽڪندڙ
लटु	لٽ
लट्कणु	لٽڪڻ
लट्काइणु	لٽڪائڻ
लट्क्यल	لٽڪيل
लठि	لَٺِ
लठि	لٺ
लड़	لڙ
लड़ाई	لَڙائيِ
लड़ाई	لڙائي
लड़ाकू	لڙاڪو
लड़्खड़ाइणु	لڙکڙائڻ
लॾ	لڏ
लॾणु	لڏَڻُ
लॾे	لڏي
लॾो	لڏو
लत	لت
लता	لتا
लताड़णु	لتارڻ
लतीफ़	لطيف
लथल्	لٿل
लप	لپ
लपाट	لپاٽ
लपेटणु	لپيٽڻ
लपेटणु	لَپيٽَڻ
लपेटणु	لَپيٽَڻُ
लफ़ंगो	لفنگو
लफ़्ज़न	لفظن
लफ़्ज़ु	لفظ
लबादो	لبادو
लबादो	لباڏو
लॿाड़	لٻاڙَ
लभणु	لڀڻ
लर्ज़णु	لرزڻ
लर्ज़श	لرزش
लर्ज़िश	لرزش
लल्कार्	للڪار
लल्चाइणु	للچائڻ
लवणु	لوڻ
लश्कर	لشڪر
लस	لس
लसन	لَسَنِ
लसाणि	لساڻ
लसुणु	لسڻ
लसो	لسو
लहण	لھڻ
लहणु	لھڻ
लहणु	لهڻ
लहणु	لهڻَ
लहणु	لَهَڻُ
लहर	لهر
लहर्दार	لهردار
लहस्जणु	لهسجڻ
लहिर	لهر
लहिस	لهس
लही	لهي
लहंदड़	لهندڙ
लह्ज़ो	لهزو
लह्राइणु	لهرائڻ
लह्री	لهري
लह्साइणु	لهسائڻ
लाअनत	لعنت
लाइ	لاء
लाइ	لاءِ
लाइ	لاءِِ
लाइक	لائق
लाइकी	لائقي
लाइकी	لائقيِ
लाइकी	لائِقيِ
लाइकीअ	لائقيءَ
लाइकु	لائق
लाइकु	لائِق
लाइक्	لائق
लाइक्	لائِق
लाइलाज्	لاعلاج
लाई	لائي
लाईन	لائين
लाओ	لائو
लाख्ड़ो	لاکڙو
लाग़र्ज़ाई	لاغرزائي
लाॻ	لاڳ
लाॻत	لاڳت
लाॻत्	لاڳت
लाॻापो	لاڳاپو
लाॻि	لاڳ
लाॻीतो	لاڳيتو
लाॻू	لاڳو
लाॻू	لاڳوُ
लाचार	لاچار
लाचारी	لاچاري
लाचार्	لاچار
लाजवाब	لاجواب
लाज़वाल	لازوال
लाज़्मी	لازمي
लाट्री	لاٽري
लाड़ो	لاڙو
लाॾाणो	لاڏاڻو
लाॾो	لاڏو
लाति	لات
लाथि	لاٿ
लानत	لعنت
लानत्	لعنت
लापता	لاپتا
लापर्वाह	لاپرواه
लापर्वाह	لاپرواهي
लापर्वाही	لاپرواهي
लापर्वाहीअ	لاپرواهيءَ
लापर्वाह्	لاپرواه
लाभाइतो	لاڀائتو
लाभु	لاڀ
लाभ्	لاڀ
लाभ्दाइक	لاڀدائق
लामारो	لامارو
लाल	لال
लालच	لالچ
लालच	لالَچ
लालचु	لالچ
लालच्	لالچ
लालु	لعل
लाल्चाइणु	لالچائڻ
लाल्चाईंदड़	لالچائيندڙ
लाल्ची	لالچي
लाल्चैण	لالچائِڻَ
लाल्च्	لالچ
लाल्टेन्	لالٽين
लावारिस	لاوارث
लावारिस	لاوارس
लाश	لاش
लाश	لاشو
लाश्	لاش
लासानी	لاثاني
लासानी	لاساني
लाहिण	لاھڻ
लाहिणु	لاھڻ
लाहिणु	لاهِڻُ
लाहिणु	لاهڻ
लाही	لاهي
लाही	لاھي
लाहे	لاهي
लाहे	لاھي
लांघाऊ	لانگھائو
लांघो	لانگھو
लिक	لِڪَ
लिक	لڪ
लिकल	لڪل
लिकलु	لڪل
लिकल्	لڪل
लिकाइणु	لڪائڻ
लिकाए	لڪائي
लिकी	لڪي
लिख	لک
लिख	لِکَ
लिखण	لکڻ
लिखणु	لکڻ
लिखाइणु	لکائڻ
लिखावट	لکاوٽ
लिखिणी	لکڻي
लिखी	لکي
लिखंदड़	لکندڙ
लिख्यल	لکيل
लिख्यल	لِکيَل
लिख्यलु	لکيل
लिॻ	لڳ
लिॻलिॻ	لڳلڳ
लिॻलिॻदार	لڳلڳدار
लिॻलिॻयो	لڳلڳيو
लिॻलिॻो	لڳلڳو
लिचिकेदार	لچڪيدار
लिच्किणो	لچڪڻو
लिच्केदार	لچڪيدار
लिटरु	لٽر
लिन्गु	لنگ
लिपी	لپي
लिफ़ाफ़े	لِفافي
लिफ़ाफ़ो	لفافو
लिबास	لباس
लिबास्	لباس
लिमो	لِمو
लियाकत	لياقت
लियाकत्	لياڪت
लियाकत्	لياقت
लियाको	لياڪو
लिहज़ु	لحاظ
लिहाज़	لحاظ
लिहाज़ी	لحاظي
लिहाज़ु	لحاظ
लिहाज़्	لحاظ
लीओ	ليئو
लीक	ليڪ
लीकणु	ليڪڻ
लीकांऊं	ليڪائون
लीको	ليڪو
लीड़	ليڙ
लीमो	ليمو
लीलाइणु	ليلائڻ
लीलाइणु	مِنٿ
लीलाईंदड़	ليلائيندڙ
लीलाए	ليلائي
लुचाई	لچائي
लुचो	لچو
लुट	لُٽَ
लुट	لٽ
लुटणु	لٽڻ
लुटमार	لٽمار
लुटाए	لٽائي
लुटेरो	لٽيرو
लुड़	لڙ
लुड़ाट्यल	لڙاٽيل
लुड़्क	لڙڪ
लुड़्हणु;	لڙھڻ;
लुॾणु	لڏڻ
लुॾिणो	لڏڻو
लुॾंदड़	لڏندڙ
लुणणु	لڻڻ
लुभाइणु	لڀائڻ
लुभाईंदड़	لڀائيندڙ
लुभाईंदड़्	لُڀائيندڙ
लुंडो	لنڊو
लूणाठो	لوڻاٺو
लूणु	لوڻ
लूमड़ु	لوُمَڙ
लूलो	لوُلو
लेखकु	ليکڪ
लेखक्	ليکڪ
लेखणु	ليکڻ
लेखिणु	ليکڻ
लेखु	ليک
लेखे	ليکي
लेखो	ليکو
लेख्	ليک
लेख्	ليکُ
लेख्णी	ليکڻي
लेटणु	ليٽڻ
लेटाइणु	ليٽائڻ
लेती	ليتي
लेथिड़्यूं	ليٿڙيون
लेथ्ड़णु	ليٿرڻ
लेप	ليپ
लेपो	ليپو
लेबल	ليبل
लेबिल	ليبل
लेसु	ليس
लोई	لوئي
लोक	لوڪ
लोकन	لوڪن
लोकु	لوڪ
लोक्नेता	لوڪنيتا
लोच	لوچ
लोड़्हो	لوڙهو
लोड़्हो	لوڙھو
लोॾणु	لوڏڻ
लोॾे	لوڏي
लोॾो	لوڏو
लोध	لوڌَ
लोधणु	لوڌڻ
लोधे	لوڌي
लोभी	لوڀي
लोभु	لوڀ
लोभु	لوڀُ
लोभ्	لوڀ
लोम्ड़ी	لومڙي
लोली	لولي
लोह	لوه
लोहार्	لوھار
लोहु	لوه
लौंग्	لونگ
लौंद्री	لونڊري
लंगूरु	لنگور
लंग्ड़ो	لنگڙو
लंघ	لانگھ
लंघ	لنگھ
लंघण	لنگھڻ
लंघणु	لنگھڻ
लंघाइणु	لنگھائڻ
लंघु	لنگھ
लंघु	لَنگُھ
लंघु	لَنگھُ
लंघे	لنگھي
लंबाई	لنبائي
लंबाईअ	لنبائيءَ
लंबी	لنبي
लंबो	لنبو
ल्याकत	لياقت
व	وَ
वकड़	وڪڙ
वकड़ु	وڪڙ
वकरु	وڪر
वकालत	وڪالت
वकालत्	وڪالت
वकित	وقت
वकील	وڪيل
वकील्	وڪيل
वकुड़णु	وڪڙڻ
वकोड़णु	وڪوڙڻ
वक्त	وقت
वक्त	وَقِتَ
वक्तसिरि	وقتسر
वक्ता	وڪتا
वक्ताइतो	وقتائتو
वक्ति	وقت
वक्तु	وقت
वक्तु	وَقِت
वक्त्	وقت
वग़ेरह	وغيره
वग़ेरह्	وَغيرَه
वग़ैरह	وغيره
वग़ैरह्	وغيره
वॻा	وڳا
वॻो	وڳو
वघार	وگھار
वचन	وچن
वचनु	وچن
वचूड़ो	وچوڙو
वच्ड़ाइणु	وچڙائڻ
वछ्ड़ो	وَڇِڙو
वज़न	وزن
वज़नाइतो	وزنائتو
वज़नु	وزن
वज़न्दार	وزندار
वज़न्दार्	وزندار
वज़ीफ़ो	وظيفو
वज़ीर	وزير
वजूद	وجود
वज़्नाइतो	وزنائتو
वॼण	وڄڻ
वॼणु	وڃڻ
वॼाइणु	وڄائڻ
वॼंदड़	وڄندڙ
वझु	وجھ
वझु	وجھُ
वञण	وَڃڻ
वञणु	وَڃَڻُ
वञणु	وڃڻ
वञणु	وڃڻُ
वञनु	وڃڻ
वञी	وَڃيِ
वञ्णु	وڃڻ
वटणु	وَٽَڻُ
वटणु	وٽڻ
वटां	وٽان
वटि	وٽ
वटिजणु	وٽجڻ
वटी	وٽي
वटु	وٽ
वठण	وٺڻ
वठणु	وٺڻ
वठणु	وٺڻُ
वठाइणु	وَٺائِڻُ
वठाइणु	وَٺائڻ
वठाइणु	وٺائڻ
वठि	وٺ
वठी	وَٺيِ
वठी	وٺي
वठंदड़	وٺندڙ
वठंदड़्	وٺندڙ
वठंदड़्	وٺندڙُ
वठ्हणु	وَٺَڻُ
वठ्हणु	وٺڻ
वॾ	وڏ
वॾन	وڏن
वॾपिणो	وڏپڻو
वॾवातो	وڏواتو
वॾा	وَڏا
वॾाई	وڏائي
वॾी	وڏي
वॾीअ	وڏيءَ
वॾीअ	وَڏيِءَ
वॾे	وڏي
वॾेरे	وَڏيري
वॾेरो	وڏيرو
वॾो	وَڏو
वॾो	وڏو
वढ	وڍ
वढणु	وَڍَڻُ
वढींदड़्	وڍيندڙ
वण	وڻ
वणटण	وڻٽڻ
वणणु	وڻڻ
वणु	وڻ
वणंदड़	وڻندڙ
वणंदड़्	وڻندڙ
वणंदड़्	وڻَندَڙ
वतन	وطن
वतन	وَطَن
वतनी	وطني
वथणु	وٺڻ
वथाणु	وٿاڻُ
वदी	وڌي
वदो	وڏو
वद्हणु	وڌڻ
वधण	وڌڻ
वधणु	وَڌَڻُ
वधणु	وَڌڻُ
वधणु	وڌڻ
वधाइणु	وَڌائِڻ
वधाइणु	وَڌائڻُ
वधाइणु	وڌائڻ
वधाईंदड़	وڌائيندڙ
वधाईंदड़ु	وڌائيندڙ
वधाउ	وڌاءُ
वधि	وڌ
वधी	وڌي
वधीक	وَڌيِڪَ
वधीक	وَڌيڪَ
वधीक	وڌيڪ
वनस्पती	ونسپتي
वन्ढणु	وَنڊَڻُ
वन्श	وَنشَ
वन्शु	ونش
वन्श्	ونش
वफ़ा	وفا
वफ़ाई	وفائي
वफ़ात	وفات
वफ़ात्	وفات
वफ़ादार	وفادار
वफ़ादारी	وفاداري
वफ़ादार्	وفادار
वफ़ादार्	وَفادار
वराइणु	ورائڻ
वराए	ورائي
वराए	وَرائي
वराणी	وراڻي
वरी	وري
वरी	وَري
वरु	ور
वरु	وَرُ
वरुण	ورڻ
वरो	وارو
वर्कु	ورق
वर्णन	ورڻن
वर्ताउ	ورتاءُ
वर्दी	وردي
वर्वकड़	وروڪڙ
वर्वकड़ु	وروڪڙ
वर्वकड़्दार	وروڪڙدار
वर्सी	ورثي
वर्सी	وَرسيِ
वर्से	ورثي
वर्से	ورسي
वर्सो	ورثو
वलर	ولر
वलरु	ولر
वलि	جي
वलि	ولي
वली	وَليِ
वस	وس
वस	وَس
वसणु	وسڻ
वसाइणु	وسائڻ
वसाइणु	وَسائِڻُ
वसि	وس
वसिजणु	وسجڻ
वसियल	وسيل
वसी	وسي
वसीले	وصيلي
वसीलो	وسيلو
वसीहत	وصيحت
वसु	وس
वसूल	وصول
वसूली	وصولي
वसूलीअ	وصوليءَ
वसंदड़्	وسندڙ
वस्कारो	وسڪارو
वस्तू	وستو
वस्तू	وَستوُ
वस्फ़	وصف
वस्यलु	وسيل
वहक	وَهَڪَ
वहणु	وھڻ
वहणु	وهڻ
वहम	وهم
वहमी	وهمي
वहमु	ڀهم
वहाइणु	ڀهائڻ
वहाए	وھائي
वहिम्	وھم
वहिशी	وحشي
वहिशी	وَحشي
वहिशी	وهشي
वहिश्यत	وحشيت
वहिंवरु	وھنوار
वहिंवार	ونھوار
वहिंवार	وهنوار
वहिंवार	وَهِنوار
वहिंवारिक	وهنوارڪ
वहिंवारु	وهنوار
वहिंवार्	وھنوار
वही	وهي
वहंदड़	وھندڙ
वहंदड़	وهندڙ
वहंदड़्	وھندڙ
वहंदड़्	وھندر
वहंदर्	وهندڙ
वह्किरो	وهڪرو
वह्क्रो	وهڪرو
वह्मि	وھمي
वह्मी	وھمي
वह्मी	وهمي
वह्शत	وحشت
वह्शी	وَحشيَ
वाइड़ो	وائڙو
वाइदो	واعدو
वाइवेला	وائويلا
वाइसी	وائسي
वाई	وائي
वाउखाई	وائُکائي
वाउरणु	وائرڻ
वाऊ	وارو
वाक	واڪ
वाक	واڪا
वाकई	واقع
वाका	واڪا
वाकिओ	واقعو
वाकिफ़	واقف
वाकु	واڪ
वाकु	واڪُ
वाकुफ़	واقف
वाके	واڪِ
वाको	واڪو
वाक्फ़्यत	واقفيت
वाखाण	واکاڻ
वाखाणि	واکاڻ
वाखाण्	واکاڻ
वाॻ	واڳ
वाघू	واگھو
वाघू	واگھوُ
वाङणाई	واڱڻائي
वाङणु	واڱَڻُ
वाङ्णाई	واڱڻائي
वाचूड़ो	واچوُڙو
वाचूड़ो	واچوڙو
वाचूड़ो	واڇوڙو
वाजिब	واجب
वाजिब	واجِب
वाजिबी	واجبي
वाजिबु	واجب
वाजिब्	واجب
वाजिब्	واجِب
वाज्बी	واجبي
वाज्ब्यत	واجبيت
वाॼो	واڄو
वाझाइणु	واجھائڻ
वाट	واٽ
वाट	واٽَ
वाटहिड़ू	واٽهڙو
वाटह्ड़ू	واٽهڙو
वाड़ो	واڙو
वाढो	واڍو
वाणी	واڻي
वात	وات
वातावरणु	واتاورڻ
वातु	وات
वादी	وادي
वादु	واد
वाधाई	واڌائي
वाधारेवारो	واڌاريوارو
वाधारो	واڌارو
वाधि	واڌ
वाधू	واڌو
वापस	واپس
वापसि	واپس
वापार	واپار
वापारी	واپاري
वापारु	واپار
वापार्	واپار
वाप्राइणु	واپرائِڻُ
वाप्राइणु	واپرائڻ
वाप्राईंदड़	واپرائيندڙ
वाप्राईंदड़्	واپرائيندڙ
वाप्सी	واپسي
वायू	وايوُ
वार	وار
वार	وارَ
वारनि	وارن
वारिस	وارث
वारिस्	وارث
वारी	واري
वारु	وار
वारे	واري
वारो	وآرو
वारो	وارو
वारंट	وارنٽ
वाल	والَ
वालारणु	والارڻ
वालु	وال
वाशरु	واشَرُ
वासणु	واسڻ
वासी	واسي
वासु	واس
वास्तव	واستَوَ
वास्तविक्ता	واستوڪتا
वास्ते	واسطي
वास्तेडार	واستيدار
वास्तेदार	واسطيدار
वास्तेदार्	واسطيدار
वास्तो	واستو
वास्तो	واسطو
वास्त्ए	واسطي
वास्ना	واسنا
वास्नामय	واسناميَ
वाह	واہ
वाह	واه
वाहणु	واهڻ
वाहाए	وھائي
वाहिदु	واحد
वाहियात	واهيات
वाहियात	واھيات
वाहियात्	واھيات
वाही	واهي
वाहु	واھ
वाह्	واہ
वांगुर	وانگر
वांगुर्	ڪافور
वांगुर्	وانگر
वांगुर्	وانگُر
वांङणु	وانڱڻ
वांझ	وانجھ
वांझ्यल्	وانجھيل
वांदो	واندو
विकामणु	وڪامڻ
विकामी	وڪامي
विकास	وڪاس
विकास्	وڪاس
विकिणणु	وڪڻڻ
विकिरण	وڪرڻ
विकिरो	وڪرو
विक्णंदड़्	وڪڻَندَڙ
विक्रे	وڪري
विक्रो	وڪرو
विख	وک
विखु	وک
विग्यान	ڀگيان
विग्यान	وگيان
विग्यानिक	وگيانڪ
विग्यानी	وگياني
विॻोड़	وڳوڙ
विच	وچ
विच	وِچَ
विचवारो	وچوارو
विचारक	وچارڪ
विचार्	وچار
विचां	وچان
विचि	وِچ
विचित्रता	وچترتا
विचीं	وچين
विचु	وچ
विचें	وچين
विचोरु	وچور
विचोलो	وچولو
विचोलो	وِچولو
विचोलो	وچولوم
विचों	وچون
विच्ड़न्दड़	وچرندڙ
विच्ड़न्दड़्	وچرندڙ
विच्ड़ी	وچڙي
विछाइणु	وڇائڻ
विछूं	وڇون
विछोटी	وڇوٽي
विछोड़णु	وڇوڙڻ
विछोड़ींदड़्	وڇوڙيندڙ
विछोड़ो	وڇوڙو
विछोत	وڇوٽ
विजई	وجئي
विजय	وجيَ
विजेता	وجيتا
विॼु	وڄ
विझणु	پوڻ
विझणु	ڪَرَڻُ
विझणु	وجھڻ
विझणु	وِجَھڻُ
विझणु	وِجھَڻ
विझणु	وِجھَڻُ
विझणु	وِجھڻُ
विझी	وجھي
विझंदड़	وجھندڙ
विझंदड़	وِجھَندَڙ
विझंदड़्	وجھندڙ
विञाइणु	وڃائڻ
विञाऊ	وڃائو
विञायल	وڃايل
विठि	وٺ
विड़्हणु	وڙهڻ
विड़्हंदड़	وڙهندڙ
विड़्हंदर्	وڙھندر
विड़्ह्यल्	وڙھيل
विथी	وٿي
विदाई	ودائي
विदेशी	وديشي
विद्या	وديا
विद्या	وِديا
विद्या	وَدَيا
विद्या	وِدِيا
विद्यार्थी	وديارٿي
विद्यार्थी	وڌيارٿي
विद्यालय	وديالي
विद्यालू	وديالو
विद्रोह	ودروه
विद्रोह	وِدِروه
विद्रोही	ودروهي
विद्रोही	ودروهيِ
विद्रोह्	ودروه
विद्वानु	ودوان
विद्वान्	ودوان
विधाता	وڌاتا
विधिवा	وڌوا
विधीअ	وڌيءَ
विनाश	وناش
विनीट	ونيت
विन्जोॻ	ونجوڳ
विन्दुराइणु	وندرائڻ
विफिलणु	وڦلڻ
विफिलंदड़ु	وڦلندڙ
विफ्ल्यलु	وڦليل
विभाॻ	وڀاڳ
विभाॻु	وڀاڳ
विभ्चारी	وڀچاري
विभ्चार्	وڀچار
विमाण्	وِماڻ
विमानु	ومان
वियल	وِيَلَ
वियलु	ويل
वियल्	ويل
वियामणु	ويامڻ
वियो	ويو
विरासत्	وراست
विराहिणु	وراھڻ
विराहींदड़ु	وراھيندڙ
विरोध	وروڌ
विरोधी	وروڌي
विरोधी	وِروڌيِ
विरोधु	وروڌ
विरोध्	وروڌ
विर्खु	ورک
विर्चाऊ	ورچائو
विर्छ	ورڇ
विर्छे	ورڇي
विर्तु	ورت
विर्लाप	ڀرلاپ
विर्लाप	ورلاپ
विर्ले	ورلي
विर्लो	ورلو
विर्हाइणु	ورھائڻ
विर्हाङो	ورهاڱو
विर्हायल	ورهايل
विर्हासत	ورهاست
विलाइती	ولائتي
विलायत	وِلايَت
विलासी	ولاسي
विलोड़णु	ولوڙڻ
विलोड़ो	ولوڙو
विवाह	وواه
विवाहित	وواھت
विविध्ता	ووڌتا
विवेक	وويڪ
विवेकी	ووڪي
विवेकी	وويڪي
विवेकु	وويڪ
विवेक्	وويڪ
विशय	وشيَ
विशाद	وشاد
विशाल	وشال
विशाल्	وشال
विश्वकोश	وشوڪوش
विश्वास	وشواس
विश्वास	وِشواس
विश्वास्घाती	وشواسگھاتي
विश्वास्घातु	وشواسگھات
विसाइणु	وسائڻ
विसामण	وسامڻ
विसामंदड़	وسامندڙ
विसारणु	وسارڻ
विसो	وسو
विस्आइणु	وِسائڻُ
विस्तार	وستار
विस्तारु	وستار
विहण	وهڻ
विहणु	وھڻ
विहणु	وهڻ
विहणु	ويھڻ
विहाणो	وهاڻو
विहार	وهار
विहारणु	وھارڻ
विहारणु	وهارڻ
विहारणु	وِهارَڻُ
विहार्यल	وهاريل
विहांअ	وھانءَ
विहांउ	وھانءُ
विहांउ	وهانءُ
विहिंझणु	وِھِنجھَڻُ
विहु	وه
विंदुर	وندر
विंदुर	وِندُرَ
विंद्राइणु	وندرائڻ
विंद्राइणु	وِندرائِڻُ
विंद्राईंदड़्	وِندرائيندَڙُ
वीचार	ويچار
वीचार	ويِچارَ
वीचारकु	ويچارڪ
वीचारणु	ويچارڻ
वीचारियल	ويچاريل
वीचारु	ويچار
वीचार्	ويچار
वीचार्यल	ويچاريل
वीचार्वान	ويچاروان
वीचार्वान्	ويچاروان
वीचार्शक्ती	ويچارشڪتي
वीझणु	ويجھڻ
वीणा	ويڻا
वीमो	ويمو
वीर	تَيزي
वीर	وير
वीरान	ويران
वीरानी	ويراني
वीरानु	ويران
वीरानो	ويرانو
वीरु	وير
वीर्ता	ويرتا
वीर्य	ويريَ
वीह	ويه
वेकरि	ويڪر
वेक्राई	ويڪرائي
वेक्रो	ويڪرو
वेख	ويک
वेगु	ويگ
वेॻाणो	ويڳاڻو
वेचारا	ويچارا
वेचार	ويچارا
वेचारा	ويچارا
वेचारो	ويچارو
वेझाई	ويجھائي
वेझिड़ाई	ويجھڙائي
वेझो	ويجھو
वेझ्ड़ाईअ	ويجھڙائيءَ
वेठल	ويٺل
वेठलु	ويٺل
वेड़्हणु	ويرهَڻُ
वेड़्हणु	ويڙهَڻُ
वेड़्हणु	ويڙهڻ
वेड़्हींदड़	ويڙهيندڙ
वेड़्हू	ويڙهو
वेड़्हो	ويڙھو
वेणी	ويڻي
वेनती	وينتي
वेन्ती	وينتي
वेन्तीअ	وينتيءَ
वेरी	ويري
वेरु	وير
वेरु	ويرُ
वेश्या	ويشيا
वेस	ويس
वेसर	ويسر
वेसरु	ڀيسر
वेसाह	ويساھ
वेसाही	ويساهي
वेसाही	ويساھي
वेसाहु	ويساه
वेसु	ويس
वेह्जी	ويهجي
वेंती	وينتي
वेंदड़	ويندڙ
वेंदे	وِيندي
वैद	ويد
वैराॻ	ويراڳ
वैराॻु	ويراڳ
वैरान	ويران
वैरानी	ويراني
वैरान्	وَيران
वैश्या	وئشيا
वैह्शी	وحشي
वोटु	ووٽ
वोट्	ووٽ
वंकी	ونڪي
वंगो	ونگو
वंड	ونڊ
वंडणु	ونڊڻ
वंडाईंदड़ु	ونڊائيندڙ
वंडियलु	ونڊيل
वंश	ونش
वंशु	ونش
वंस	ونس
वंहिवार	وهنوار
वंहिंजणु	ونهنجڻ
वंह्वारु	ونهوار
व्यक्तीवादु	ويڪتيواد
व्यम	ويم
व्यलु	ويل
व्यवस्त्हित	ويوسٿت
व्यवस्था	ويوسٿا
व्याकुल	وياڪل
व्याकुल्	وياڪل
व्याकुल्ता	وياڪلتا
व्याक्रण	وياڪرڻ
व्याख्या	وياکيا
व्यापक	وياپڪ
व्रह्स्पत्	ورھسپت
व्हेल	وهيل
शऊरु	شعور
शक	شڪ
शक	شق
शकाइतो	شَڪائِتو
शकिजी	شڪجي
शकी	شقي
शकी	شَڪيِ
शकी	شڪي
शकु	شڪ
शकु	شق
शक्जणु	شقجڻ
शक्ती	سَھَڻ
शक्ती	سَختي
शक्ती	شڪتي
शक्तीहीन	شڪتيهين
शख़्स	شخص
शख़्सियत	شخصيت
शख़्सियत	شخصييت
शख़्सी	شخصي
शख़्सु	شخص
शगुन	شگن
शटरु	شٽر
शत्रंज्	شطرنج
शनासी	شناسي
शनीवार	شنيوار
शफ़ाफ़	شفاف
शफ़ाफ़ी	شفافي
शफ़्तालू	شفتالو
शबद	شبد
शब्द	شبد
शब्दावली	شبداولي
शब्दु	شبد
शब्द्कोश	شبدڪوش
शब्द्भंडारु	شبدڀنڊار
शमादान्	شمعدان
शम्बक	شمبڪ
शयूं	شيون
शरण	شرڻ
शरणि	شرڻ
शरम	شرم
शरम्नाक	شرمناڪ
शराफ़त	شرافت
शराब	شراب
शराबी	شرابي
शराबु	شراب
शराबु	شَرابُ
शरारत	شرارت
शरारती	شرارتي
शरीक	شريڪ
शरीर	شرير
शर्ड़ाटु	شرڙاٽ
शर्त	شرط
शर्ती	شَرتيِ
शर्ती	شرطي
शर्तु	شرط
शर्बतु	شربت
शर्म	شرم
शर्मिंदगी	شرمندگي
शर्मिंदो	شرمندو
शर्मिंदो	شَرمِندو
शर्मीलो	شرميلو
शल	شل
शल	شَلَ
शश्माही	ششماهي
शस्त्र	شستر
शस्त्र	شَسِتِرَ
शस्त्र्	شستر
शहर	شهر
शहरु	شهر
शहाणो	شهاڻو
शहिन्शाह्	شَهِنشاھ
शहिर	شَھِرَ
शहिर	شھر
शहिर	شهر
शहिरु	شھر
शह्ज़ादी	شهزادي
शह्ज़ादो	شهزادو
शह्तूत	شهتوت
शह्री	شهري
शह्वती	شھوتي
शाइकु	شائق
शाइर	شاعر
शाइरा	شاعرا
शाइरी	شاعري
शाइरु	شاعر
शाइस्तिगी	شائستگي
शाइस्तो	شائستو
शाख़	شآخ
शाख़	شاخ
शाख़	شاخا
शाख़ा	شاخا
शागिर्द	شاگرد
शागिर्द	شگرد
शागिर्दु	شاگرد
शादीا	شادي
शादी	شآدي
शादी	شادي
शादीअ	شاديءَ
शाद्माअनो	شادمانو
शाद्मानो	شادمانو
शान	شان
शानाइतो	شانائتو
शानु	شان
शान्ती	شانتي
शान्तीअ	شانتيء
शान्दार	شاندار
शान्दार्	شاندار
शाफ़ी	شافي
शाबास	شاباس
शाबासि	شاباس
शाबासी	شاباسي
शामियानो	شاميانو
शामिल	شامل
शामिल्	شامل
शाम्	شام
शाम्यानो	شاميانو
शायद	شايد
शाला	شالا
शास्ट्‘र	شاستر
शास्त्र	شاستر
शास्त्रविधी	شاستروڌي
शास्त्री	شاستري
शाहाणो	شاھاڻو
शाहिद	شاهد
शाहिदी	شاهدي
शाही	شاهي
शाही	شاھي
शाहूकार	شاهوڪار
शाहूकारी	شاهوڪاري
शांत	شانت
शांती	شانتي
शांतीअ	شانتيءَ
शांतीमय	شانتيميَ
शांत्	شانت
शांदार	شاندار
शिकनि	شڪن
शिकस्त	شِڪَستَ
शिकस्त	شڪست
शिकस्तन्	شڪستن
शिकस्ती	شڪستي
शिकस्तो	شڪستو
शिकस्त्	شڪست
शिकायत	شڪايت
शिकायत्	شڪايت
शिकार	شڪار
शिकारी	شڪاري
शिकारु	شڪار
शिकिल	شڪل
शिकिल्	شڪل
शिकिस्तिगी	شڪستگي
शिकंजो	شڪنجو
शिरेश्टु	شريشٽ
शिर्धा	شرڌا
शिलालेख्	شلاليک
शिल्प्शाला	شلپشالا
शिशु	شش
शिशु	شِشُ
शीख़	شيخ
शीदी	شيدي
शीदी	شيِديِ
शीरीन	شيرين
शीरीनी	شيرينيِ
शीर्शक	شيرشڪ
शील्ता	شيلتا
शीशाऊं	شيشائون
शीशी	شيشي
शीशी	شيِشيِ
शीशे	شيشي
शीशे	شيِشي
शीशो	شيشو
शीशो	شيِشو
शीहो	شيھو
शुकुर्गुज़ार	شڪرگزار
शुकुर्गुज़ारी	شڪرگزاري
शुकुर्वार्	شڪروار
शुक्राणू	شڪراڻو
शुक्राना	شڪرانا
शुदा	شده
शुध	شڌ
शुधि	شڌ
शुधी	شڌي
शुभ	شڀ
शुमारु	شمار
शुरू	شروع
शुरूअ	شروع
शुरूआत	شروعات
शुरूआति	شروعاتي
शुरूआती	شروعاتي
शुरूआते	شروعاتي
शुरूआत्	شروعات
शुरूउ	شروع
शूकणु	شوڪڻ
शूके	شوڪي
शूम	شوم
शूम्	شوم
शेख़ी	شيخي
शेवा	شيوا
शेवाधारी	شيوداري
शै	شَي
शै	شيءَ
शै	شئ
शै	شَئ
शै	شئي
शैतान	شيتان
शैतान	شيطان
शैतान	شَيطان
शैतानी	شيطاني
शैतानु	شيطان
शैतान्	شيطان
शैम्पू	شيمپو
शैरु	شعر
शोक	شوڪ
शोख़	شوخ
शोख़ीअ	شوخيءَ
शोख़्	شوخ
शोड़्	شوڙ
शोरु	شوڙُ
शोर्बो	شوربو
शोलो	شولو
शोंक	شونق
शौक	شوق
शौक	شٓوق
शौकत	شوَڪت
शौकीन	شوقين
शौकीन	َشوقين
शौकीन्	شوقين
शौकु	شق
शौकु	شَوق
शंका	شنڪا
श्रधा	شرڌا
श्रधांजली	شرڌانجلي
श्री	شري
श्रीमती	شريمتي
श्रीमान	شريمان
श्रूउ	شروع
श्रेश्ट्ता	شريشٽتا
सक्ख्त्	سخت
सक्रिय	سڪريَ
सख़तु	سخت
सखर	سکر
सख़ावत	سخاوت
सखिणो	سکڻو
सख़ी	سخي
सख़्णो	سَخڻو
सख्णो	سکڻو
सख़्त	سخت
सख़्ती	سختي
सख़्तीअ	سختيءَ
सख़्तु	سخت
सख़्तु	سَخِتُ
सख़्त्	سخت
सग़ेरु	سغير
सॻ	سڳ
सॻाई	سَڳائيِ
सॻु	سڳ
सॻुणु	سڳڻ
सॻो	سڳو
सॻोरो	سڳورو
सघ	سگھ
सघण	سگھڻ
सघणु	سگھڻ
सघारो	سگھارو
सघिजे	سگھجي
सघे	سگھي
सङ	سڱ
सङु	سڱ
सच	سچ
सचाई	سچائي
सचाई	سَچائي
सचाईअ	سچائيءَ
सचार	سچار
सची	سچي
सचु	سچ
सचेत	سچيت
सचो	سچو
सचो	سَچو
सच्पचु	سچ
सच्पचु	سچپچ
सज़ा	سزا
सजाइणु	سجائڻ
सजावट	سجاوٽ
सज्यल	سجيل
सज्यल	سَجيل
सॼणपिणो	سڄڻپاِڻو
सॼणु	سڄڻ
सॼण्	سڄڻ
सॼे	سڄي
सॼो	سَڄو
सॼो	سڄو
सॼोई	سَڄوئي
सॼोई	سڄوئي
सटणु	سٽڻ
सटा	سَٽا
सट्को	سٽڪو
सठि	سٺ
सड़क	سڙڪ
सड़ण	سڙڻ
सड़णु	سڙڻ
सड़ियलु	سڙيل
सड़ी	سڙي
सड़ो	سڙو
सड़्यल	سڙيل
सॾ	سَڏَٰ
सॾणु	سَڏَڻُ
सॾणु	سڏڻ
सॾयल	سَڏِيَل
सॾाइणु	سڏائڻ
सॾियलु	سڏيل
सॾु	سڏ
सणाओ	سڻائو
सण्भाणि	سڻڀاڻ
सण्भु	سڻڀ
सण्भो	سڻڀو
सत	ست
सतरियों	سَتَرِيون
सतह	سطح
सतही	سطحي
सताइणु	ستائڻ
सताईंडड़	ستائيندڙ
सताईंदड़	ستائيندڙ
सतायल	ستايل
सतारन	ستارن
सतिरोंह	سَترونه
सतु	ست
सतु	سَتُ
सतों	ستون
सत्यता	ستيتا
सत्यवान	ستيوان
सत्यानास	ستياناس
सत्रहं	سترهن
सत्वाड़ो	ستواڙو
सथर	سٿر
सथो	ساٺو
सदल	سدل
सदा	سدا
सदाईं	سدائين
सदाचार	سداچار
सदाचारी	سداچاري
सदारत	صدارت
सदिको	صدقو
सदिरी	صدري
सदीअ	صديءَ
सद्भाव	سدڀاو
सद्भावु	سدڀاو
सद्मो	سدمو
सद्मो	صدمو
सद्री	صَدِريِ
सद्ल	سَدَلِ
सनक	سنڪ
सनान	سنان
सन्की	سنڪي
सन्कोच	سنڪوچ
सन्ग्दिल	سنگدل
सन्ॿंध्	سَنٻَنڌ
सन्यास	سنياس
सन्यासी	سنياسي
सन्सनी	سنسني
सन्सनीख़ेज़	سنسنيخيز
सन्सारी	سنساري
सन्सारु	سنسار
सन्स्था	سَنسِٿا
सन्स्थाउन	سنسٿائن
सन्ही	سنهي
सन्हीं	سنھي
सन्हो	سنهو
सन्हो	سنھو
सन्हों	سنهو
सन्हों	سنهون
सपाटो	سپاٽو
सपु	سپ
सप्ने	سپني
सप्नो	سپنو
सफ़र	سفر
सफ़रु	سفر
सफ़र्	سفر
सफ़ा	سفا
सफ़ा	صفا
सफ़ाई	سفائي
सफ़ाई	صفائي
सफ़ाईअ	سفائيءَ
सफ़ाईअ	صفائيءَ
सफ़ीर्	سفير
सफ़ेद्	سفيد
सबकु	سبق
सबबु	سب
सबबु	سبب
सबब्	سبب
सबुर	شَڪتي
सबुर	صبر
सबुर	صَبُرَ
सबुरु	صبر
सबुर्	صبر
सबुर्वारो	صبروارو
सबूत	ثبوت
सॿाझो	سٻاجھو
सभ	سڀ
सभा	سَڀا
सभा	سڀا
सभाॻ	سڀاڳ
सभाॻो	سڀاڳو
सभापती	سڀاپتي
सभासद	سڀاسد
सभिनी	سَڀِني
सभिनी	سڀني
सभियता	سڀيتا
सभु	سڀ
सभ्	سڀ
सभ्को	سَڀڪو
सभ्को	سڀڪو
सभ्नी	سڀني
सभ्य	سڀيَ
सभ्यता	سَڀيَتا
समझ्दार	سمجھدار
समन	سمن
समनु	سمن
समर्थक	سمرٿڪ
समर्थन	سمرٿن
समर्पण	سمرپڻ
समर्पनु	ثمرپن
समस्या	سمسيا
समह	سَمَه
समाइणु	سمائڻ
समाईंदड़	سمائيندڙ
समाए	سمائي
समाचरु	سماچار
समाचार	سماچار
समाज	سماج
समाजिक	سماجڪ
समाज्	سماج
समाद्ही	سماڌي
समाधान	سماڌان
समाधी	سماڌي
समान	سمان
समान्ता	سمانتا
समापती	سماپتي
समापन	سماپن
समापन्	سماپن
समाप्ती	سماپتي
समायल्	سمايل
समालोच्ना	سمالوچنا
समुजाइणु	سمجھائڻ
समुझ	سمجھ
समुझणु	سمجھن
समुझाणी	سمجھاڻي
समुझ्दारी	سمجھداري
समुंड	سمنڊ
समुंडु	سمنڊ
समूरो	سمورو
समूरो	سَمورو
समूरो	سَموُرو
समेत	سميت
समेलन्	سميلن
सम्कालिक	سمڪالڪ
सम्झ	سمجھ
सम्झ	سمجھَ
सम्झण	سمجھڻ
सम्झणु	سمجھڻ
सम्झाइणु	سمجھائڻ
सम्झाइणु	سمجھائڻُ
सम्झाइणु	سَمجھائِڻُ
सम्झाइणु	سَمجھائڻُ
सम्झाईंदड़ु	سمجھائيندڙ
सम्झाणी	سمجھاڻي
सम्झाणी	سَمجھاڻيِ
सम्झी	سمجھي
सम्झू	سمجھو
सम्झू	سمجھوُ
सम्झोतो	سمجھوتو
सम्पदा	سمپدا
सम्पादक	سمپادڪ
सम्पादकी	سمپادڪي
सम्पादन	سمپادن
सम्पूरक	سمپورڪ
सम्भाव्न	سمڀاونا
सम्मोहक	سمموهڪ
सम्मोहणु	سمموهڻ
सम्मोहित	سَمِموھِتِ
सर	سر
सरल	سرل
सराइ	سراءِ
सराई	سرائي
सराफ़	صراف
सरासर	سراسر
सरासरी	سراسري
सरासरु	سراسر
सरासर्	سراسر
सरीखो	سريکو
सरूप्	سروپ
सरोवर्	سروور
सरौ	سرہ
सरंदे	سرندي
सर्कणु	سرڪڻ
सर्कार	سرڪار
सर्कारी	سرڪاري
सर्गरम	سرگرم
सर्गर्म	سرگرم
सर्गर्मी	سرگرمي
सर्गस	سرگس
सर्गोशी	سرگوشي
सर्ॻवासी	سرڳواسي
सर्ॻु	سَرڳ
सर्चाइणु	سرچائڻ
सर्जणु	سرجڻ
सर्डर	سَردار
सर्दार्	سردار
सर्दी	سردي
सर्दो	سردو
सर्द्	سرد
सर्नामो	سرنامو
सर्फ़े	سرفي
सर्फ़े	صَرفي
सर्फ़ो	صرفو
सर्बस्तो	سربستو
सर्व	سلو
सर्स	سَرِسِ
सर्सराहट	سرسراهٽ
सर्सरी	اختصار
सर्सरी	سراسري
सर्सरी	سرسري
सर्सी	سرسي
सर्सु	سرس
सर्ह	سره
सर्हद	سرحد
सर्हो	سرهو
सलणु	سلڻ
सला	سلا
सलामत	سلامت
सलामती	سلامتي
सलामतीअ	سلامتيءَ
सलामतेअ	سلامتيءَ
सलामी	سلامي
सलाह	صلاح
सलाह	صَلاح
सलाह्	صلاح
सलाह्कार्	صلاحڪار
सलूक	سلوڪ
सलो	سلو
सलो	سَلو
सल्वार्	سلوار
सवड़	سوڙ
सवलाई	سولائي
सवलाईअ	سولائيءَ
सवले	سولي
सवलो	سولو
सवाइ	سواء
सवाइ	سواءِ
सवाइ	سَواءِ
सवाइ	سوائي
सवादी	سوادي
सवादु	سواد
सवारणु	سوارڻ
सवाल	سوال
सवालु	سوال
सवेल	سويل
सवेल	سَويلَ
सव्लाई	سولائي
सव्लाईअ	سولائيءَ
सव्लो	سولو
ससु	سس
सस्ताई	سستائي
सस्तो	سستو
सहज	سهج
सहज्ता	سهجتا
सहण	سھڻ
सहण	سهڻ
सहण	صَبُر
सहणु	سهڻ
सहणु	سَهَڻُ
सहन	سهن
सहन्शक्ती	سهنشڪتي
सहन्शील	سهنشيل
सहन्शील्ता	سهنشِلتا
सहन्शील्ता	سهنشيلتا
सहाइता	سھائتا
सहायक	سھايڪ
सहायक	سهايڪ
सहायक्	سھايڪ
सहारो	سھارو
सहारो	سهارو
सहिकन्दे	سهڪندي
सहिक्यल	سهڪيل
सहिंजु	سھنج
सही	سحيح
सही	سهي
सही	صحي
सही	صحيح
सही	صحيِح
सहीह	صحيح
सहीह्	صحيح
सहूलियत	سهوليت
सहूल्यत	سهوليت
सहूल्यत	سَهوُلِيَتَ
सहूल्यत	سھوليت
सहूल्यत	سھوُليَت
सहो	سهو
सहो	سھو
सहंदड़	سهندڙ
सह्कारी	سهڪاري
सह्कीअ	سَهڪيِءَ
सह्कंदो	سَهڪَندو
सह्क्रियाशील	سهڪرياشيل
सह्जो	سهجو
सह्ण	سھڻ
सह्मत्	سَھِمَت
सह्योगी	سهيوگي
साइत	ساعت
साइबान	سائبان
साइंस	سائنس
साइंस्दान	سائنسدان
साई	سائي
साईं	سائين
साईं	سائيِن
साओ	سائو
साकार	ساڪار
साख	آبرو
साख	ساک
साखाइतो	ساکائتو
साख़्तीअ	سختيءَ
साख्यात	ساکيات
साख्यात्	ساکيات
सागर	ساگر
सागरु	ساگر
सागू	ساگو
साॻयाई	ساڳيائي
साॻये	ساڳي
साॻये	ساڳئي
साॻयो	ساڳيو
साॻियो	ساڳيو
साॻीअ	ساڳيءَ
साॻे	ساڳي
साज़िशी	سازشي
साज़िश्	سازش
साज़ी	سازي
साज़ु	ساز
साञह	ساڃھ
साटिन	ساٽن
साड़णु	ساڙڻ
साड़ु	ساڙ
साड़े	ساڙي
साॾड़ु	ساڌڙ
साणु	ساڻ
साणो	ساڻو
साथी	ساٿي
साथु	ساٿ
साथ्	صحبت
सादिगी	سادگي
सादिगीअ	سادگيءَ
सादो	سادو
साधन	ساڌن
साधनु	ساڌن
साधन्	ساڌن
साधारण	سآڌارَڻُ
साधारण	ساڌارڻ
साधारणु	ساڌارڻ
साधितु	ساڌت
साधू	ساڌو
सान्त	سانت
सान्तीको	سانطيقو
साफ़	ساف
साफ़	صاف
साफ़ु	صاف
साफ़्	صاف
साफ़्गू	سافگوُ
साफ़्गू	صافگو
साबित	ثابت
साबित	صابت
साबिती	ثابتي
साबुण	سابڻ
साबुणु	صابڻ
साबू	سابو
साब्ती	ثابتي
साब्तीअ	ثابتيءَ
साभ्या	ساڀيا
सामगिरी	سامگري
सामग्री	سامگري
सामान	سامان
सामानु	سامان
सामान्	سامان
सामूंडी	سامونڊي
सामूंदी	سامونڊي
साम्ग्री	سامگري
साम्राज्य	سامراجِيَ
साम्हूं	سامهون
साम्हूं	سامھون
साम्हूं	ساڱهون
साम्हों	سامهون
सार	سار
साराह	ساراہ
साराह	ساراه
साराहिणु	ساراهِڻُ
साराह्	ساراه
साराह्णु	ساراهِڻُ
सारियूं	ساريون
सारु	پرز
सारु	سار
सारु	سارُ
सारो	سارو
सार्थक	سارٿڪ
सार्यूं	ساريون
साल	سال
सालिम	سالم
सालिम	سامل
सालियानो	ساليانو
साली	سالي
साल्	سال
साल्मी	سالمي
साल्यानो	ساليانو
सावक	ساوڪ
साव्धान	ساوڌان
साव्धानि	ساوڌان
साव्धानी	ساوڌاني
साव्धान्	ساوڌان
साश्टांग	ساشٽانگ
साह	ساه
साहस	ساھس
साहस	ساهس
साहित	ساهت
साहितिक	ساهتڪ
साहित्य	ساھتيَ
साहिबी	صاحبي
साहिब्	صاحب
साहिमी	ساهمي
साही	ساهي
साहु	ساھ
साहु	ساھُ
साहु	ساه
साहु	ساهُ
साह्तिक्	ساھتڪ
साह्तियकार्	ساھتيڪار
सां	سان
सांओं	سانئون
सांगु	سانگ
सांगे	سانگي
सांचो	سانچو
सांझी	سانجھي
सांढींदड़	سانڊيندڙ
सांढ्यल	سانڊيل
सांत	سانت
सांतीको	سانتيڪو
सांदह	سانده
सांभर	سانڀر
सांविरो	سانورو
सिक	سڪ
सिकणु	سڪڻ
सिकायल	سڪايل
सिके	سڪي
सिको	سڪو
सिखणु	سکڻ
सिखिया	سکيا
सिखंदड़	سکندڙ
सिख्या	سکيا
सिख्या	سِکيا
सिग्नल	سگنل
सिग्नल्	سگنل
सिङु	سڱ
सिङो	سڱو
सिज	سج
सिजु	سج
सिझाइणु	سجھائڻ
सिझ्यलु	سجھيل
सिट	سٽ
सिटुन	سٽن
सिणीअ	سڻيءَ
सितारन	سِتارَن
सितारो	ستارو
सिधांत	سڌانت
सिधांतु	سڌانت
सिधो	سڌو
सिनेमा	سنيما
सिप	سپ
सिपाही	سپاهي
सिफ़ारत्	سفارت
सिफ़ारश	سِفارَشِ
सिफ़ारिश	سفارش
सिबणु	سبڻ
सिम	سم
सिमणु	سمڻ
सिम्रण	سمرڻ
सियणो	سياڻو
सियाटिजणु	سياٽجڻ
सियाणप	سياڻپ
सियारो	سيارو
सियासत	سياست
सियासत्दान	سياستدان
सियासी	سياسي
सिर	سر
सिरण	سِرَڻِ
सिरणु	سِرَڻُ
सिराप्	سراپ
सिरि	سر
सिरिश्तो	سرشتو
सिरु	سر
सिरो	سرو
सिरंदड़	سرندڙ
सिर्	سر
सिर्कणु	سرڪڻ
सिर्को	سرڪو
सिर्फ़	صرف
सिलाई	سلائي
सिलाए	سلائي
सिल्सिलेवार	سلسليوار
सिल्सिलेवार्	سلسليوار
सिल्सिलो	سلسلو
सिल्स्लो	سلسلو
सिसी	سسي
सिहत	صحت
सिहत्	صحت
सिहत्बख़्शि	صحتبخشي
सिहत्बख़्श्	صحتبخش
सिहत्मंद	صحتمند
सिंघणु	سنگھڻ
सिंचाई	سنچائي
सिंहासनु	سنهاسن
सीउ	سيءُ
सीक्यूं	سيڪيون
सीटणु	سيٽڻ
सीटि	سيٽ
सीड़प	سيڙپ
सीड़ाइणु	سيڙائڻ
सीधो	سيڌو
सीने	سيني
सीमा	سيما
सींगार	سينگار
सींगारणु	سنگارڻ
सींगारणु	سينگارڻ
सींगारींदड़ु	سينگاريندڙ
सींगारु	سينگار
सींगार्	سينگار
सींगार्	سينگارُ
सींगार्यल	سينگاريل
सुइचि	سئچ
सुई	سئي
सुक	سُڪَ
सुक	سڪ
सुकणु	سُڪَڻُ
सुकणु	سڪڻ
सुकल	سڪل
सुकलु	سڪل
सुकी	سڪي
सुको	سڪو
सुख	سک
सुखा	سکا
सुखी	سکي
सुखु	سک
सुख्दर्सी	سکدرسي
सुख्दर्सु	سکدرس
सुख्यो	سکيو
सुॻंधि	سڳنڌ
सुॻंध्	سڳنڌ
सुजाॻ	سجاڳ
सुजाॻी	سجاڳي
सुजाॻी	سُجاڳيِ
सुजाॻु	سجاڳ
सुॼणु	سُڄَڻُ
सुॼणु	سڄڻ
सुॼयल	سڄيل
सुॼयल	سُڄِيَل
सुॼाण	سڄاڻ
सुझणु	سجھڻ
सुझाइणु	سجھائڻ
सुञ	سڃ
सुञाई	سڃائي
सुञाणणु	سڃاڻڻ
सुञाणप	سُڃاڻَپَ
सुञाणप	سڃاڻپ
सुञाणिणु	سڃاڻڻ
सुञातल	سڃاتل
सुञातल्	سڃاتل
सुञी	سڃي
सुञो	سڃو
सुञ्यलु	سڄيل
सुटु	سٽ
सुठाई	سٺائي
सुठी	سٺي
सुठीअ	سٺيءَ
सुठे	سٺي
सुठो	سُٺو
सुठो	سٺو
सुडोउल	سڊول
सुडौल	سڊول
सुॾकणु	سڏڪڻ
सुॾका	سڏڪا
सुण्कणु	سڻڪڻ
सुतलु	ستل
सुती	ستي
सुत्जणु	ستجڻ
सुथ्रो	سٿرو
सुध	سڌ
सुधार	سڌار
सुधारक	سڌارڪ
सुधारण	سڌارڻ
सुधारणु	سُڌارَڻُ
सुधारणु	سڌارڻ
सुधारींदड़्ٌ	سڌاريندڙ
सुधारु	سڌار
सुधारु	سڌارڻ
सुधारो	سڌارو
सुधि	سڌ
सुधिर्यल	سڌريل
सुधु	سُڌُ
सुध्रण	سڌرڻ
सुध्रणु	سڌرڻ
सुन	سن
सुन्द्री	سندري
सुन्सान	سنسان
सुप्त्मनु	سپتمن
सुप्रिदिगी	سپردگي
सुप्रीडेइंट	سپريڊينٽ
सुफ़ेद	سفيد
सुफ़ेदी	سفيدي
सुफ़्हो	صفحو
सुबतो	سُبَتو
सुबाउ	سڀاءُ
सुबुहु	صبح
सुभऔ	سڀاءُ
सुभवीक	سڀاويڪ
सुभाउ	سڀاءُ
सुभाउ	سڀاؤ
सुभाणे	سڀاڻي
सुभाव	سڀاو
सुभाव	سوڀاو
सुभावीक	سڀاويڪ
सुभां	سڀان
सुम्हणु	سمهڻ
सुम्हारणु	سمهارڻ
सुम्हियल	سمھيل
सुम्हियलु	سمھيل
सुर	سر
सुरक्शा	سرڪشا
सुरियलु	سريل
सुरीलो	سريلو
सुरु	سر
सुरेत	سريت
सुरो	سرو
सुरंग	سرنگ
सुरंघ	سرنگھ
सुरंदड़	سرندڙ
सुर्की	سرڪي
सुर्ख़	سرخ
सुर्ॻु	سرڳ
सुर्मो	سرمو
सुर्हाणि	سرهاڻ
सुलछ्णो	سلڇڻو
सुलभ	سلڀ
सुलह	صلح
सुलह्पसंद	صلحپسند
सुलिह	سُلهَ
सुल्झाइणु	سلجھائڻ
सुल्टो	سلٽو
सुल्तनत	سُلطِنَت
सुल्हाइतो	صلحائتو
सुवार	سوار
सुवारी	سواري
सुवारीअ	سواريءَ
सुवारु	سوار
सुवाल	سوال
सुवाली	سوالي
सुवालु	سوال
सुशील	سشيل
सुश्री	سشري
सुसणु	سسڻ
सुसाइणु	سسائڻ
सुसंदड़	سسندڙ
सुस्त	سست
सुस्ती	سستي
सुस्तु	سست
सुस्त्	سست
सुस्पुसि	سسپس
सुहिणो	سهڻو
सुहिणो	سھڻو
सुहिबत्	ساٿ
सुहंदो	سهندو
सुह्णो	سهڻو
सुह्णो	سھڻو
सूअर	سوئر
सूअरी	سوئري
सूअरु	سوئر
सूओ	سوُئو
सूखिड़ी	سوکڙي
सूख्ड़ी	سوکڙي
सूख्ड़ी	سوُکڙي
सूख्यम	سوکيم
सूख्य्म्ता	سوکيمتا
सूचक	سوچڪ
सूची	سوچي
सूच्ना	سوچنا
सूजी	سوجي
सूट	سوٽ
सूतिली	سوتلي
सूतो	سوتو
सूदो	سودو
सूधाई	سوڌائي
सूधो	سوڌو
सूफ़	صوُفَ
सूफ़ी	صوفي
सूफ़ु	صوُفُ
सूफ़्याणो	صوفياڻو
सूॿट	سوُٻَٽ
सूॿट्	صوٻت
सूमर	سومر
सूर	سور
सूरज	سورج
सूरज्मंडल	سورجمنڊل
सूरट~	سوُرَت
सूरण्	سوُرَڻُ
सूरत	صورت
सूरु	سور
सूर्ती	صورتي
सूर्मी	سورمي
सूर्मो	سورمو
सूर्मो	سوُرمو
सूर्वीर	سوروير
सूर्वीर	سوُرويِرِ
सूर्ह्याई	سورهيائي
सूलह	صلح
सूसाट	سوساٽ
सूसाटु	سوساٽ
सूं	سون
सूंझ	سونجھ
सूंझणु	سونجھڻ
सूंझे	سونجھي
सूंझो	سونجھو
सूंझ्	سونجھ
सूंझ्णो	سونجھڻو
सूंझ्णो	سوُنجھڻو
सूंडि	سونڊ
सूंडु	سونڊ
सूंह	سونهن
सूंहं	سونھن
सूंहं	سوُنھن
सूंहं	سونهن
सेकणु	سيڪڻ
सेकु	سيڪ
सेकंडु	سيڪنڊ
सेक्ड़ो	سيڪڙو
सेक्स	سيڪس
सेखत	سکيت
सेखत	سيکت
सेखारण	سيکارڻ
सेखारणु	سيکارَڻُ
सेखारणु	سيکارڻ
सेखारींदड़	سيکاريندڙ
सेख्ड़ाट	سيخڙات
सेख्ड़ाट	سيکراٽ
सेख्राट्	سيکراٽ
सेन	سينا
सेना	سينا
सेनाजो	سيناجو
सेमाब	سيماب
सेमो	سيمو
सेर्वर	سرور
सेवकु	سيوڪ
सेवा	سيوا
सेवाधारी	سيواڌاري
सेंडल	سينڊل
सेंधो	سينڌو
सेंवर	سينور
सेंवरु	سينور
सेंवार्यल्	سينواريل
सैनिकु	سينڪ
सैरु	سير
सैरु	سَير
सैर्बीन्	سئربين
सैलानी	سَيلاني
सैलाबु	سيلاب
सो	سو
सोए	سوئي
सोकड़ि	سوڪڙ
सोघो	سوگھو
सोच	سوچ
सोच	سوچَ
सोचणु	سوچڻ
सोचियल	سوچيل
सोचींदे	سوچيندي
सोचु	سوچ
सोच्	سوچ
सोॼ	سوڄ
सोड़्ह	سوڙھ
सोड़्हो	سوڙهو
सोड़्हो	سوڙھو
सोढा	سوڍا
सोध	سوڌ
सोनारो	سونارو
सोनु	سون
सोनो	سونو
सोपारी	سوپاري
सोफ़	سوفا
सोभ	سوڀ
सोभारो	سوڀارو
सोराख़	سوراخ
सोराख़ु	سوراخ
सोर्हां	سورهان
सोस	سوس
सोसि	سوس
सौ	سوّ
सौ	سَوُ
सौॻंध्	سوڳنڌ
सौटु	سوٽ
सौदाई	سودائي
सौदाई	سَودائي
सौदाई	سَوِدائي
सौदाउ	سوداءُ
सौदाउ	سَوِداءُ
सौदागर	سوداگر
सौदागर	سَوِداگَر
सौदो	سودو
सौदौ	سوداءُ
सौमान	سومان
सौर	سور
सौंटो	سونٽو
सौंपणु	سَونپڻ
सौंपणु	سئونپَڻُ
संऊं	سنئون
संकट	سنڪٽ
संकट्	سنڪٽ
संकोच	سنڪوچ
संकोची	سنڪوچي
संक्रांति	سنڪرانت
संखु	سنک
संगठन	سنگٺن
संगीत	سنگيت
संग्तरन	سنگترن
संग्तराश	سنگتراش
संग्तराशी	سنگتراشي
संग्दिल्	سنگدل
संग्मर्मर	سنگمرمر
संग्रहालय	سنگرهالي
संघर्शु	سنگھرش
संघु	سنگ
संचालक	سنچالڪ
संचालकु	سنچالڪ
संजीदो	سنجيدو
संजीद्गी	ڪنجيدگي
संझा	سنجھا
संडास	سنڊاس
संत	سنت
संतरी	سنتري
संतान	سنتان
संतान्	سنتان
संतु	سنت
संतुलन	سنتلن
संतुश्ट	سنتشٽ
संतोश	سنتوش
संतोशी	سنتوشي
संतोश्	سنتوش
संत्रो	سنترو
संदसि	سندس
संदिली	صندلي
संदूक	صندوق
संदेश	سنديش
संदेह्वाद	سنديهواد
संधणु	سنڌڻ
संधाणो	سنڌاڻو
संॿन्ध	سنٻنڌ
संॿन्धी	سنٻنڌي
संॿन्ध्	سنٻنڌ
संॿंध	سنٻنڌ
संॿंधी	سنٻنڌي
संॿंध्	سنٻنڌ
संभव	سنڀو
संभव	سنڀَوَ
संभव	سَنٻَو
संभाल	سنڀال
संभालणु	سمڀالڻ
संभालणु	سنڀالڻ
संभालींदड़	سنڀاليندڙ
संभालींदड़्	سنڀاليندڙ
संभालींदड़्	سنڀاليندر
संभाले	سنڀالي
संभाव्ना	سنڀاونا
संभिर्यल	سنڀريل
संमान	سنمان
संयम	سنيم
संयमी	سنيم
संयमी	سنيمي
संयोजक्ता	سنيوجڪتا
संवारणु	سنوارڻ
संवार्यल	سنواريل
संवेदन	سنويدن
संवेदन्शील	سنويدنشيل
संसाई	سنسائي
संसारी	سنساري
संस्था	سنسٿا
संस्था	سَنسٿا
संहाणि	سنهاڻ
संहिरो	سَنِهِرو
स्अरासर	سراسر
स्याणप	سياڻپ
स्याणो	سياڻو
स्याही	سياھي
स्रिश्टी	سرشٽي
स्लीपरु	سليپر
स्लेटी	سليٽي
स्वणु	سوڻ
स्वदेशी	سوديش
स्वागत	سواگت
स्वागतु	سواگت
स्वागत्	سواگت
स्वार	سوار
स्वारीअ	سواريءَ
स्वार्थ	سوارٿ
स्वार्थी	سوارٿي
स्वार्थु	سوارٿ
स्वाल	سوال
स्वीकार	سويڪار
स्वीक्रिती	سويڪرتي
हक	حق
हक	حَقَ
हकालणु	ھڪالڻ
हकालणु	هڪالڻ
हकी	حقي
हकी	ھڪي
हकीकत	حقيقت
हकीकत	حَقيِقَت
हकीकती	حقيقتي
हकीकी	حقيقي
हकीम	حڪيم
हकीम्	حڪيم
हकु	حق
हकु	حَقُ
हको	هڪو
हकोनाहक	هڪوناهڪ
हक्दार	حقدار
हक्यो	هڪيو
हक्लणु	ھڪلڻ
हक्लन~अ	هڪلن
हचा	ھچا
हचा	ھَچا
हचा	هچا
हछ्रो	هلچل
हज़म	حزم
हज़म	حضم
हज़म	هضم
हजामत	حجامت
हजाम्	حجام
हज़ार	هزار
हज़ारु	هزار
हटणु	هَٽَڻُ
हटणु	هٽڻ
हटाइण	ھٽائڻ
हटाइणु	ھٽائڻ
हटाइणु	هٽائڻ
हटाई	هٽائي
हटी	هٽي
हटु	ھٽ
हटु	هٽ
हटो	هٽو
हटंदड़	هٽندڙ
हट्कणु	هٽڪڻ
हठि	هٿ
हठीलो	هٺيلو
हठीलो	ھٺيلو
हठु	ھٺ
हठु	هٺ
हड़	هڙ
हड़प	ھڙپ
हड़प	هَڙَپ
हड़्ताल	هڙتال
हड़्ताली	هڙتالي
हड़्बड़ी	ھڙبڙي
हड़्ॿड़ी	هڙٻڙي
हड़्ॿड़्यो	ھڙٻڙيو
हॾ	ھڏ
हॾन	هڏن
हॾनि	هڏن
हॾा	ھڏا
हॾीअ	ھڏيءَ
हॾो	ھڏو
हणणु	ھڻڻ
हणणु	هَڻَڻُ
हणणु	هڻڻ
हत्या	ھتيا
हत्या	هتيا
हथ	ھَٿَ
हथ	ھٿ
हथ	هٿ
हथन	هٿن
हथां	ھٿان
हथां	هٿان
हथि	هٿ
हथिड़ो	هٿڙو
हथियार	ھٿيار
हथियार्	ھٿيار
हथु	ھٿ
हथु	هٿ
हथेली	هٿيلي
हथें	هٿين
हथो	ھٿو
हथोड़ो	ھٿوڙو
हथोराड़्यूं	هٽوراڙيون
हथों	هٿون
हथ्	هٿ
हथ्कड़ी	هٿڪڙي
हथ्कड़ी	ھٿڪڙي
हथ्यारु	هٿيار
हथ्यार्	ھٿيار
हथ्रादू	ھٿرادو
हद	حد
हद	حَدَ
हद	هد
हदायत	ھدايت
हनणु	هڻڻ
हन्गामो	هنگامو
हन्जु	هنج
हन्धि	ھنڌ
हन्धि	هنڌ
हन्धु	هنڌ
हपणु	هپڻ
हफ़्ता	هَفتا
हफ़्ते	هفتي
हफ़्तेवार	هفتيوار
हफ़्तो	هفتو
हब्शी	حبشي
हॿक	ھٻڪ
हॿकणु	ھٻڪڻ
हॿकणु	هٻڪڻ
हॿछी	هٻڇي
हॿिकणु	هٻڪڻ
हम	ھم
हमाम	حمام
हमेश	ھميشہ
हमेशह	هميشه
हमेशा	هميشه
हम्ख़्याल्	ھمخيال
हम्जेॾो	ھمجيڏو
हम्दर्द	همدرد
हम्दर्दी	همدردي
हम्राज़	ھمراز
हम्लावर	حملاور
हम्लो	حملو
हम्वज़्नी	ھَموَزنيِ
हम्सरी	همسري
हयाउ	حياء
हयात	حيات
हयात्	حيات
हर	ھر
हर	هر
हर	هَر
हरणु	هرڻ
हरहिकु	هرهڪ
हराम	حرام
हराम	هرام
हरामु	حرام
हराम्	حرام
हरु	هر
हरु	هرُ
हरू	هرو
हर्कती	حرڪتي
हर्को	هرڪو
हर्गिज़	هرگز
हर्फ़	حرف
हर्फ़ु	حرف
हर्मु	هرم
हर्यो	ھريو
हलण	ھلڻ
हलणु	ھلڻ
हलणु	هلڻ
हलत	حلت
हलत्	حلت
हलत्	ھَلَتِ
हलाइण	هلائڻ
हलाइणु	زبان
हलाइणु	ھلائڻ
हलाइणु	ھَلائِڻُ
हलाइणु	هلائڻ
हलाईंदड़ु	ھلايندڙ
हलाईंदड़्	ھلائيندڙ
हलाईंदो	ھلائيندو
हलाख	ھلاک
हलाख	هلاک
हलाख	هَلاک
हलाखी	ھلاکي
हलाखु	حلاڪ
हलाख्	حلاک
हली	هلي
हलीम	حليم
हलीम्	حليم
हलु	حل
हलंदड़	هلندڙ
हलंदड़्	ھلندڙ
हलंदर	ھلندر
हलंदी	هلندي
हलंदीअ	ھلنديءَ
हलंदो	هلندو
हल्की	هلڪي
हल्को	ھلڪو
हल्को	نَلِڪو
हल्को	هلڪو
हल्चल	ھلچل
हल्चल	هلچل
हल्चल्	هلچل
हवा	جھوٽو
हवा	هوا
हवा	هَوا
हवा	ھوا
हवाई	هَوايِ
हवाई	هوائي
हवाख़ोरीअ	هواخوريءَ
हवादार	هوادار
हवादार्	ھوادار
हवाबाज़ी	هوابازي
हवालात	حوالات
हवालात्	حوالات
हवाले	حوالي
हवाले	هوالي
हवालो	حوالو
हवेली	حويلي
हशाम्	ھشام
हश्मत	حشمت
हसद	حسد
हसद	حُسَد
हसद्	حسد
हसास	حساس
हसीन	حسين
हस्त	ھست
हस्ती	ھستي
हस्ती	هستي
हा	ها
हाइ	هاءِ
हाओ	هائو
हाक	هاڪ
हाकारो	هاڪارو
हाकिम	حاڪم
हाकिम्	حاڪم
हाक्मी	حاڪمي
हाज	حاج
हाज़िमी	هاضمي
हाज़िर	حاضر
हाज़िरी	حاضري
हाज़िर्	حاضر
हाज़िर्जवाब	حآضرجواب
हाज़ुर	حاضر
हाज़्मो	ھازمو
हाज़्मो	حاضمو
हाज़्री	حاضري
हाज़्रीअ	حاضريِءَ
हाज़्रीन्	حاضريِن
हाञी	ھاڃيِ
हाञीदार्	هاڃيِدار
हाठी	هاٺي
हाठीअ	هاٺيءَ
हाणे	ھاڻي
हाणे	هاڻي
हाणोके	هاڻوڪي
हाणोको	هاڻوڪو
हाथापाई	هاٿاپائي
हाथी	ھاٿيِ
हाथीअ	ھاٿيءَ
हाथीअ	هاٿيءَ
हाद्से	حادثي
हाद्से	حاصِدي
हाद्सो	حادثو
हाफ़िज़	حافظ
हार	هار
हार	هارَ
हाराइण	هارائڻ
हाराइणु	هارائڻ
हाराए	هارائي
हारायल	هاريل
हारायल्	ھارايل
हारी	ھاري
हारी	هاري
हारु	ھار
हार्जणु	ھارجڻ
हार्मोनियम्	ھارمونيم
हाल	حال
हालत	حالت
हालत	حالَت
हालतूं	حالتون
हालत्	حالت
हालु	حال
हालु	هال
हाल्	ھال
हाश्यो	حاشيو
हासिद्	حاسد
हासिल	حاصل
हास्लियत	حاصليت
हास्ल्यत	حاصليت
हास्ल्यत्	حاصليت
हाहा	هاها
हिक	ھڪ
हिक	هِڪَ
हिक	هڪ
हिकजहिड़ाई	هڪجهڙائي
हिकदम्	ھڪدم
हिकॿिए	هڪٻئي
हिकु	ھڪ
हिकु	هِڪُ
हिकु	هڪ
हिक्	هڪ
हिक्ड़ो	هِڪڙو
हिक्ड़ो	هڪڙو
हिचक	هچڪ
हिचिकणु	هچڪڻ
हिच्कणु	ھچڪڻ
हिच्किचाहट्	ھچڪچاھٽ
हिजाब	هجاب
हिजे	هجي
हिति	ھت
हिते	ھتي
हिते	هتي
हिते	هِتي
हिदायत	ھدايت
हिदायत	هدايت
हिन	ھن
हिन	هن
हिन्सक	هنسڪ
हिफ़ाज़त	حفاظت
हिॿिकणु	هٻڪڻ
हिम	هم
हिमत	ھمت
हिमत	همت
हिमथ	دِل
हिमथ	ھمٿ
हिमथ	ھِمَٿَ
हिमथ	ھمت
हिमथ	ھمث
हिमथ	همٿ
हिमथो	ھمٿو
हिमायत	حمايت
हिमायती	همايتي
हिम्ताइणु	همتائڻ
हिम्थाइणु	ھمٿائڻ
हिम्थाइणु	هِمٿائِڻُ
हिरणु	ھرڻ
हिरास्	ھراث
हिरियलु	هريل
हिर्खाइणु	ھرکائڻ
हिर्खाइणु	هرکائڻ
हिर्खाईंदड़	هرکائيندڙ
हिर्फ़त	هرفت
हिर्फ़ती	حرفتي
हिर्फ़ती	هرفتي
हिर्यल	ھريل
हिलाइणु	هلائڻ
हिसा	حصا
हिसाब	حساب
हिसाब	حِساب
हिसाब	حصاب
हिसाबन	حسابن
हिसाबी	حسابي
हिसाब्	حساب
हिसे	حصي
हिसेदार	حصيدار
हिसेदारी	حصيداري
हिसो	حسو
हिसो	حصو
हिसो	حِصو
हिंदाणो	هنداڻو
हिंयाव	هنياو
हिंसक	هنسڪ
हिंसा	هنسا
ही	هي
ही	ھي
हीअ	هيءَ
हीउ	هيءُ
हीणाई	ھيڻائي
हीणो	هيڻو
हीणो	ھيڻو
हीर	هير
हीर	ھير
हीरो	ھيرو
हीस्यल	هيسيل
हींअर	هينئر
हुअण	هئڻ
हुअणु	هئڻ
हुअणु	هُئَڻُ
हुअणु	ھئڻ
हुअण्	ھئڻ
हुअण्हार	هئڻهار
हुकुम	حقم
हुकुम	حڪم
हुकुमु	حقم
हुकुम्	حڪم
हुकूमत	حڪومت
हुकूमत्	حڪومت
हुको	حقو
हुक्मत	حڪمت
हुजणु	هجڻ
हुजणु	هُجَڻُ
हुजण्	ھجڻ
हुजत	هجت
हुजे	ھجي
हुतां	هتان
हुते	هتي
हुते	هُتي
हुन	ھن
हुन	هن
हुनर	ھنر
हुनरी	ھنري
हुनुर	هنر
हुनुरु	ھنر
हुनुरु	هنر
हुनुर्	ھنر
हुनुर्मंद	هنرمند
हुन्री	ھنري
हुब	هب
हुॿस	هٻس
हुरणु	هُرَڻُ
हुरु	ھُرُ
हुल	هل
हुलु	هل
हुलु	هُلُ
हुशी	ھشي
हुश्यार	هوشيار
हुश्यारीअ	هوشياريءَ
हुश्यार्	ھوشيار
हुसुन्	حسن
हू	هو
हू	ھو
हू	ھوُ
हूअ	هوءَ
हूबहू	هوبهو
हूबहू	هوُبَهوُ
हूबहू	ھوبھوُ
हूर	حور
हूशियार्	ھوشيار
हूंदे	هوندي
हूंदे	هوُندي
हे	هي
हेकर	هيڪر
हेक्ड़ाई	هيڪڙائي
हेक्लाई	هيڪلائي
हेक्लो	هيڪلو
हेठ	هيٺ
हेठां	هيٺان
हेठां	ھيٺان
हेठांहीं	هيٺاهين
हेठि	هيٺ
हेठि	ھيٺ
हेठियों	هيٺيون
हेठियों	ھيٺيون
हेठ्मथाहीं	هيٺمٿاهين
हेठ्मथे	هيٺمٿي
हेठ्यों	ھيٺيون
हेॾांहुं	هيڏانهن
हेॾे	هيڏي
हेत्रो	هيترو
हेरणु	هيرڻ
हेरणु	ھيرڻ
हेरा	هيرا
हेराइणु	ھيرائڻ
हेराकु	هيراڪ
हेराक्	ھيراڪ
हेस्ताईं	هيستائين
हैड	هيڊ
हैबत	حيبت
हैबत्नाक	هيبتناڪ
हैबत्नाक्	حَيبَتناڪ
हैबत्नाक्	ھَيبتناڪ
हैरत	حيرت
हैरत	هيرت
हैरान	حيران
हैरानी	حيراني
हैरान्	حيران
हैवान	حيوان
हैवानी	حيواني
हैस्यत	هيثيت
हो	هو
होॾ	هوڏ
होॾ	ھوڏ
होॾांहुं	هوڏانه
होॾी	هوڏي
होॾी	ھوڏي
होॾे	هوڏي
होर्न्	ھورن
होश	هوش
होश	ھوش
होशियार	هوشيار
होशियारी	هوشياري
होशियारीअ	هوشياريءَ
होशियार्	ھوشيار
होश्यार	هوشيار
होश्यारी	هوشياري
होश्यारी	ھوشياري
होश्यारीअ	هوشياريءَ
होश्यार्	هوشيار
होसिलो	حوصلو
होस्लो	حوصلو
हौज़	حوض
हौज़ु	حوض
हौज़ु	حَوض
हौस्लो	هوصلو
हंगणु	ھنگڻ
हंगामो	هنگامو
हंज	ھنج
हंडाइणु	هنڊائڻ
हंध	ھنڌ
हंधि	ھنڌ
हंधि	هنڌ
हंधु	ھنڌ
हंधु	ھَنڌُ
हंधु	هنڌ
हंसु	هنس
